it a different angle	ah shit i lost track
we just finished	*planned to go to bo
x and ben and ethan?	noperino
t sounds like they k	sam ernest and bowen
oh ok so ya	the smart bois they 
oh nice	you wanna have sched
ben are just worried	btw i just reorganiz
ant ppl in ur house?	yeh not rn at least
n do u wanna do them	what time u free my 
's or tuesday nights	alright sounds good
ing for cmu regular?	i'm going to call th
but dietrich! :d	i already emailed th
nice	nah, it's harder to 
at was so much worse	bruh
c of her personality	lol, nice backpedali
od at comforting ppl	but i'm losing any f
 than restructure it	i actually like weed
 get started on that	let's be real here, 
on't feel it but mit	you actually want me
ome ppl might be mad	hey, how about we ma
final boss meme	truuu
t realize that today	i just had it stuck 
rce out applications	feelssad man
 thats pretty catchy	yeh?
/watch?v=a_426riwst8	is it going to have 
psh not tht crazy	damn, you're really 
even a 3.51	that 3.51 was a rich
't care abotus ports	division iii school
üê±	maybe this isn't hea
ould be able to tell	i know this will sou
ya sure	i need this shit man
t more in the essays	thx man, it's good t
;t mean to be brutal	nah, it's perfect
r have 20 in empathy	but my human side is
lmaooo	yeh, i had a similar
e a good personality	damnit, so don't say
fic character traits	you fucking genius
üê±	lol and you thought 
 at creative writing	you must have some e
 was never very good	ahhh
ball toss?	yup yup
ya	i'm just about to st
anything for the lab	alright, thanks man,
 wednesday night tho	ooh, that comes out 
yup	alright, i'll buy yo
eel like i should be	those lines sound ve
:')	also that feel when 
andom race on ur app	our names kind of gi
 i just made that up	and if they call you
 sexual harassment!"	"i"m not exotic"
f affirmative action	like wut
same	a kid from the proje
on income make sense	maybe when we have i
m.tst.perfm.1995.pdf	holy shiz, 1995?
ing, just a summary)	what's the sum all '
thats the results	lol that chart looks
ppl perform the same	has this been replic
reotypically smarter	after reading a lot 
retty accepted thing	hmmm, not sure how t
cultural stereotypes	so you're telling me
economy collapse tho	let's hope that auto
probably a good idea	i wanted to continue
you in school today?	ye
?	die
uh	not gonna lie i spen
e's just competitive	they don't release s
fuck	what's wrong?
that sucks	oh
o i just read ur msg	i thought you meant 
r u busy rn?	it's all right, it's
can i come over?	lol sure i suppose
finished circuit lab	vara just stopped by
alking in like 5 min	kk
sed a call from you.	y u call meh
got in	:ooooo
holy	congrats!!!!
ing al the relatives	this better not be a
lmao	alright, heard from 
yeeeaaaaaaaa	wooohoooooooo
do u k	i know
wait so deferral?	idk
:/	he figured it out by
massive cold ones	now he says he's tri
m or anything before	alright, apparently 
lol	idk lol
so its ok	hmm, enough of this 
ill out with the fam	holy crap, that's qu
i'm glad to hear it	love ya justin
there less sappy	"you're gonna kickas
lol	so are you just gonn
d over ur essays lol	awww
do u mean in person?	oh ur choice lol eit
same	wait really
ah it's in arlington	oh wow, that's quite
y so i'll get a ride	ahh
cya tomorrow	cya
hat lunch do u have?	i got second
welp	did you hear?
so did nico barlos	wowow, harvard sure 
tly probing everyone	i don't know who tha
i told them	nioce nioce
and stuff	to be fair i also on
nice man	aaron ames is from u
üê±	what'chu doin' my ma
art of the webassign	lmaoo
nice	let me know if you n
this is the ramp one	i also put ff = 0
ok	where u at
ged for my interciew	oh man
class of '59 lol	lydia is apparently 
lol truuu	you can also ask abo
thanks!	what can i buy with 
a straw	you coming back for 
nished the interview	lol
 we drop the guy off	awww alright
o the sci oly meet ;	lol
we're actually short	but howwww
how'd it go	went well i think it
eally ask me anythng	really???
lol	lol
hopefully	i think jenn is also
? y	i talked with vara a
after what i sent u	wut
hen blocked me again	lol alrighty then
 being such a waste.	wait i didn't mean t
yup...	you sacrificed a lot
sed a bunch of lines	sorry lol just saw a
and then this	well he was true to 
ust so fucking toxic	you better lawyer up
lmao	did that help cheer 
not viable	:'(
tadaa	u got meh
come fix my hardware	<3
bc its unhealthy	it does seem like a 
rst over competition	since when are you t
thanks <3	i believe he also ha
kinda a bad argument	ngl sounds like what
xd	lmaoo
e thought about that	it might seem "corre
r ppl besides us two	oh man
working relationship	is that girls feel l
lololololololol	lol sorry just got a
en and i are heading	sometimes whatever h
true	you've been handling
out with the boiiiis	da boissssss
 not been banned lol	i never had an accou
ok	has vara talked to y
*gif	took some googling
rip butterbot :'(	envy is an ugly crea
le to come if u want	lmao perhaps
 can decide tomorrow	alrighty
i told her about it	is she one the bois 
ulda shown it to her	one day it'll be leg
yea boi	dun mean to bother y
lose with these days	<3
me "we need to talk"	if you want context 
üê±	perhaps if i just sh
let's do it	are u at the school 
nope lol	i feel
damn really	yeh man dat shiz' he
nice	nvm i'm walking stra
oh ok	7819603202
g an upgraded laptop	:0
and touch screen	ew
and better display	touch screen
60-laptop/dncwtr753h	wait idk how compati
o has better display	when u getting this 
re still shipping it	holy shit 1500?!
or the same price :d	lol
einstaled some stuff	dayumnnn
n when hes not lmaoo	lolll
es to get through it	tru :'(
quality memes	jeezus bruh lol
 have fun workin out	thx thx
laying smash in econ	training montage
lol get u back later	i just woke up lol
 that would be great	i'll be done before 
we can grin them out	i only did the first
ok	i'm also taking a hu
castinated until now	tired times?
ya.. twas a bad idea	nah it's fine
doing 3	kk
ave a class a block?	yup yup
ver them in d block?	dun worry we can fin
lmao ok	üí™
im doing 1 now	you did 1 last??
th an atwood problem	lmaoo
lmao	you're the best at e
e from -2.4 m/s to 0	how u find dat
ya	wutttt
no i got it	lol
at u got from part a	"did you do it this 
t get why that works	https://web.njit.edu
 actually do physics	lmaooo
hmm	i'm not sure what to
at i did makes sense	maybe you broke phys
 that happened today	?
 got into columbia!)	nice!!!
ot of personal drama	more so than what ha
o me for some reason	she's mad that you a
 what the result was	i don't think you sh
oh lol	idk when she got ann
 she would be pissed	are you really hung 
guess i shouldn't be	nah, it's alright to
rytime i talk to her	lol dun worry that k
so meh	i don't think i've e
 little drama fucker	nah it's alright lol
ya.... ugh	btw do you know if t
the wut	bruh
wtf	on dynamics
whats dynamics	lol
sically pulley stuff	idk, that's why i wa
lol	i feel
uz i hae no clue why	do you want me to as
actually u can	i don't really know 
y jen's so mad at me	btw the quiz tomorro
what is chapter 5	friction
i think	that's like 4 chapte
other rotating stuff	btw does your pops t
lol probabky	is everything cool n
will be ok next week	maybe jenn also want
"carrying laundry"	yeh...
 can probably help u	are we going to have
for about 2 hrs lol	g'night!
cya	sweet dreams
a wut	we had to buy an nhs
feels like the mafia	yeeee
oh that's nice	or
mhm what'd i tell ya	not sure if going to
flaking for tfa part	i literally did no w
it's worth it :d	lmao thanks
lol r u asleep	doing work
r u coming?	i thought you guys w
l it's 16 min before	that's a lot of minu
g from stop and shop	cold ones of course
here	finally fuking finis
nice	got any tips for get
d press with a towel	i read that as
it on ur linux side?	nope windows
hmm thats wierd	yo man, you doin' al
im still sick af lol	just makin' sure lol
is hw for english d:	lol
t good for my throat	yeh, then just don't
ym by feel like shit	my head is spinning 
so idts	maybe i got a delaye
obaby just sleep tbh	but all dese apps n 
welp	can't tell if restin
welp	u mia rn?
ya	not coming to botbal
nope	ahh ic ic
its soooo wholesome	dat songs old news
 got my new computer	niceeeee
bc they felt bad	staying at home toda
nah i'm in school	yeh this is like the
ever use touchscreen	u gunna dualllll
ya ofc	d-d-d-d-d-d-duallll
of crashing	that's just a window
:)	oh god
*gap yeaaaaaarrrr*	are you trying to ha
have the video done?	nope doing audio ton
rejected by colleges	nah this isn't about
personality was shit	ayyyyyyy
 may accomplishments	what if they just re
n ultimate powermove	i wonder what they a
ey won't really care	tell a story yup yup
t chickens in french	oh god the memes
:'(	just run your own ba
for different things	yeh
eming so hard rn lol	it hurts and soothes
k if u need anything	<3
till under for hours	nope
ait chakladar cooks?	bruh
essional ppl to cook	also wanna tutor mur
my tuoring and hours	even for graduation?
 much for graduation	i think 30?
well shit	lmao
ns always wednesday?	monthly
nteering after jan 2	so you're up for sou
what time?	4:30 - 6:30
's the soup kitchen?	fuck if i know
if someone drops out	c'monnnn
 ok how do i sign up	you can take my spot
uh no it's ok	bring some food back
u should gooo	come with meh pls
maybe next month	:'(
and part of the 2nd	alright
do they take long	nah
so	üê±
üê±	we gotta put in the 
izzes uncontrolably*	lmaooo
ty of unemployed men	hot dayumn
ut smthn in ur house	üê±
ru at the school?	i'm at üè°
just curious	did you want to come
t i got picked up so	lol
n an a- in the class	you wanna do my oc h
nah	it'll help you get r
rite my college apps	i'm trying to help y
icking englihs essay	üê±
 shoulda taken drama	it's an amazing clas
yup	danggg
n't started stanford	you gots any time an
üê±	dear god
16	16.04.3 lts?
and ya	the different flavor
ah ic	it's like trying ana
atable with packages	you don't know until
 to first base first	yeh
t it was eye contact	eye contact during a
y not in the gutters	apparently there was
killing someone else	how could the intern
bes hamlet's murder"	doesn't that just de
oh ok	btw if you say "her 
sn't a verb u dingus	no it is
 or a contrived noun	i anal, you anal, we
 prnouncing it wrong	"siri, do you do ana
roy get back to work	"i'm sorry, i'm afra
get back to work too	that could be the mo
stop	üê±
can't even do anal	this is getting more
roy ur really wierd	i wasn't the one who
e nickname for umich	congrats!!!
holesome to be memed	we don't really meme
st seemed normal lol	"normal"
cts in the basements	ouch
r promotional videos	lmao
lol	i noticed that the m
ell that makes sense	some or rather a lot
e main idea snippets	"french food bloggin
to vietnam sometimes	main ideas :')
the school for a bit	haaaa
lmao	do you have a good m
when do u need it by	probs this weekend
sure	i also think my mart
fake news	https://docs.google.
doing any of it yet?	i scrapped the old v
ne i was interruptes	lmao
eedback after school	i just went back hom
oh nice	you just hanging out
talking to petty rn	feel free to drop by
copters for sci oly?	do i really have a c
 the rest of us suck	nah, that's not it l
 kinda talk about it	wait, we're just int
r are u *scaaarreed*	maybe after i finish
(pussssssyyyy)	ok i'm done
g quizbowl questions	you can if you want
ok	wait, you don't thin
arc for urself	you mean stuff like 
not super emphasized	i already kind of ta
how dem apps going	unmotivated lol
sammmmee	wanna try to have a 
:/	lol
much better colleges	yeh i suppose so
 progress on my apps	i think i'm done wit
llege apps for a day	my fam never does st
oh lol	my folks and i aren'
that visit ever	the last time my rel
oh	gotta love them drin
ns except winchester	are you going to be 
cramming can't solve	"tell us about somet
h my family friends)	if i take out that b
ady for some editing	you can edit any of 
ssays are all ready?	ready for editing
ing much for my apps	have you done brains
 for different ideas	oh yeh did you retra
idk how to do that	ayyy
cinded applicants xd	how can i withdraw m
ying early for gtech	isn't jenn and vara 
whats the room	one sec
ok i'm in	nioce
oh	fuk
fuck yaaa	0-1
6% more damage ;)	im ready
should do stage bans	lets go
hold on	kk
parents to their car	dfuk
fuck	oh wut
this lag	aw yeh
is so laggy	yeh ok man
characters if u lose	weak
im banning dreamland	:'(
 u pick waiting room	oh goddamnit
ew	aw shit what
ok this fucking lag	what stage ban and m
thats also platforms	lol
bout pokemon stadium	:'(
ning pokemon stadium	kk
lol	got it
boom	i call bs
h doesnt count ok :d	fine fine
boooom	that match didn't co
:d	hey
ok	we still got one mor
uld stick with isaac	for best of 5
nah i'll go ichigo	wait you won the las
true	imma choose a map no
fuck	3-2
out its 10 - 3 me ;)	how about we go by g
r more mandatory fun	what is this mandato
nd parties and stuff	wow lol
ya ikr	:'(
 just until the 27th	:(
*same	so dual boot collegi
he mic in my mailbox	nah nah it's fine
8-1	only the most recent
ake puns with ichigo	ichigo in japanese m
richchiggoa	lmao
l feel more personal	i'm at the limit
oh nvm then	bruh
oh nice nice	this stuff is cringe
 see star wars again	again???
hurts from the smell	lol
legne essay for mit?	i wrote about growin
ya sure	you free for a colle
t's later in the day	anytime
 probably not for me	awww
lol wut	*there's grind time 
can probably make it	are you out of town 
acks conference call	is it like a big one
ts starting in 5 min	ooh
oh nop	how long will the me
omorrow we can grind	it's never too late 
ya ill come tomorrow	<3
e me some motivation	here watch this
lmao	still need motivatio
nt has mostly passed	do you need a gf?
tresses me out a lot	üê±
yes	allow me
ya i saw that	what happened at mah
o doing college apps	i believe this is wh
 take my mind off it	he isn't even workin
 can take care of it	neither is sarah eit
when whos talking xd	üê±
üê±	there, now you know 
wait	if you're over worry
 is justified üò≠üò≠üò≠üò≠üò≠üò≠	i think you should g
hi sam	just go to sleep bru
i mean roy	üê±
hi roy	did you finish weedt
:'(	at that point i thin
ya true	quality over quantit
d to make some memes	fuck you
yes	why u do dis
 good for my soul ok	tru
lol ya cya tomorrow	what time you wanna 
how about like 7?	yeh sure
estions are so wierd	coming to my place o
prbablu ur place	kk let me know when 
in 15 min	kk
here	dayumn
to come	thanks for the catch
nge question for mit	still???
t and doing stanford	ahh
 really a challeneg"	ahh
ould be more just me	you can't mention ma
 a compelling topic?	depends on how you s
the better i got lol	isn't that a solutio
oh	welp shit then i bet
 like for volleyball	i think you should w
and see what happens	nice nice
sement for gcer prep	not sure
i hope u feel better	it was from summer v
 did over the summer	but i couldn't reall
lololok	if you need me to re
all of them?	nah
ant to give u doubta	you can read them if
ly probably less tbh	holy shiz
nahhhh i'll be fine	alright man
's the final stretch	we got midterms afte
only have 3 midterms	hot dayumn
üê±	üê±
a community *accept*	oh tru
at's penetrating who	hot dayumn
st like college apps	grad school doe
fck	wait are you looking
my first 10 startups	don't worry, if i be
 suure why it sent 3	triple da pus
d college to succeed	i wonder if i can be
ya u should sleep	you know wat, all th
üê±	üê±
nford common dataset	those lying motherfu
u thin ktheyre good?	which one are those
he where i come from	i meant which essay 
lol	i think i actually m
oh lmao	how you seduced me w
üê±	i like the community
er part of the essay	bruh
yay	it's probably just m
na change the world"	i'm the guy who told
yay	i can't think of any
 working on stanford	i just saw the extra
ng a maker portfolio	"performing their fa
 will love that shiz	"oh shit, this guy h
 really add anything	üê±
n't take source code	they don't???? then 
thats super exciting	i thought he said he
ote about it i guess	what?! just showing 
 look at source code	no wayyyyyyyyyyyyyyy
ill have much effect	how the general publ
lmao	actually scratch the
nna read her essays?	yeh sure
agu/edit?usp=sharing	hot dayumn, you alre
 they can be my josh	lol
e fricking expensive	truuu
i du already submit?	i just submitted oli
lol	just the act of subm
nice!	you doin' alright ma
and no probably not	kinda just wanna see
almost slacking time	maybe i should've me
it what was this for	oh god i'm psyching 
ons decision anyways	tru
nd ya i'm doing fine	idk i'm dumb and wat
 to pray to r&njesus	i thought all of the
hools have 2 readers	and shit i just real
ld do that right now	ehhhhh does it matte
weaaakkkk	fuck weedtown those 
ill probably trust u	alright i'll send no
oh lol	i'll just send them 
üê±	why they wanna let c
arents to pay for it	nah just in general
e's a section on mit	ik on mit
t's always better to	ughhhhhh
mystery train lic...	ayy
oh well	i think we need an a
bias is also a thing	shhhhh
smh smhsmhsmhsmhsmhs	lol
lol	do you know mr. burk
 be on ur common app	it's not doe
sure it was required	both his email and h
lol ok	you have his number?
üê±	pls stahp
back to college apps	same
nice!	feels strange
did u submit?	lmao
üê±	how you doin'?
itional info section	wow you
poor looks	"oh no i'm the leade
youth cities	ooohhhh
cruiting was a thing	it's going to be a t
t sandbag soccer :'(	lmao
no	didn't polcari get a
not sure	when mit tries to ge
lol damn	üê±
what happppeend	idk
ubmitted evyerhting?	not mit, buzz, nor c
due feb wut	yup
lenge essay for mit?	lol sure
‚Äúbigger and better.‚Äù	i like it
ts not readyy yetttt	the ap part seems a 
rification and stuff	careful doe, they ca
ah ok	last sentence i mean
g anywhere else lmao	i thought you said t
as like a side thing	i guess the core of 
ee about fixing that	i guess i'm at that 
 thats also valuable	instead of doing som
of just sitting back	it's not about colle
really isn't meaning	thx man that was sup
eaningful than it is	yeh
th motivate me a lot	i used to think that
less u want funding)	üê±
üê±	i say all this but i
i should to	maybe i'll put this 
 sounds pretty scary	that girl sounds lik
:o	it says that person 
xd	holy shit
n't very respectable	hot damn
mpletely roasted him	did he get in?
it didn't say	damnnnnnn
as posting his draft	that's quite the roa
e david but creepier	lol
t of place it sounds	i wonder if that per
r mit activity list?	one sec
oh ok	are you close to bei
 the additional info	lol
pp is so restrictive	yeh it really is
t as my description.	lol
gotta have that sap	funnily enough, i ac
ur activity section?	yeh
damn boi 40 words	i gave the shortest 
te an essay about it	lol
lmao	lmao
wait what were ur 4?	is that going to be 
per and papercrafts?	ppr from sophomore y
 that ur internship?	did you know i was i
 u worked for aptima	i made a paper in bo
h that kind of paper	ppr stands for paper
the hours and weeks?	da fuk is a scholast
wards / distinctions	oh truuu
form since 9th grade	that's uh
like 10th grade	wait, how many weeks
im not obssessed	yeh, that helps your
i said 36	alrighty
for all my clubs	really?? isn't botba
for botball i did 38	we don't do botball 
r and extra meetings	alright, i'll put 38
in weeks	how about we just se
 them before as well	so 36 or 38?
38 for botball	kkkk
nto my app essay tho	oh, i was going to b
lol ya sure	and talk about makin
he basement days lol	lol
e until i burned out	lol, maybe i should 
or eating or talking	i consider my person
 has been so helpful	i was also estimatin
 wonder i burned out	wat
üê±	are you freaking ins
 wakeup time to be 7	bruh
uling up to 1 am now	wow
ram sess this yr lol	nope never burned ou
many hours did u put	oh wait
wait wut	i'm saying your summ
ah ok	dat feel when you re
hats not a bad thing	"robotics isn't viab
üê±	pressing that submit
are u doing it now?	i'll do it tomorrow 
lmao	alright, all that's 
is at 1300 words wtf	lol
hen i clicked "save"	oh did, you click th
e what the limit was	yup
's website right now	that's either some h
üê±	yeh, it's really str
nk i'm gonna keep it	you look like a nerd
s from my paragraphs	really?
the deed is done	congrats!!!!
thx	idk why i'm doing th
one with submitting?	still reviewing mit
ave 5 or 6 or scales	6?!
the rest of ur stuff	wait, i actually don
wdym	wait, the gpa's they
ollege applications.	welp shiz, should've
 school has a as 3.7	welp shit, our uw mu
ghted gpa to schools	you sure?
eting with guidance?	yeh you're right
 panic will kill you	thx evolution
üê±	"i submitted my comm
auto reject	trying to figure out
 easier cuz balance?	yeh they are
do u ask	looking for the next
you'll be fine	i'm not actually sur
 stanford app for me	holy fucking shit
ng the last question	alright, i'mma help 
 when i need editing	i'mma read all dat j
 school tomorrow ntw	wat
s is hitting so hard	aren't u done doe
 stuff for new years	wait wat, you didn't
it's due tonifht	oh jan 2
woops	bruh
chicago, around 3 pm	nice nice
out tomorrow instead	bruh
or are u in class rn	i'm working out rn l
lmao	i typed that while d
ee time just hmu pls	you can send it now
lometers into space.	imao actuator
rs know what that is	üê±
ing i should change?	the pair of one hand
wdym by expansion	cuz it doesn't direc
ok	though i doubt you h
 down on some places	yup yup
d my own code is :'(	lol
of computer language	since you're talking
 so many languages!"	üê±
ok anything else?	hmm not really subst
not yet	alright i'll just re
extra hr prompt lmao	what did you do?
lol	wow nerd
me if its too wierd:	that's one of the mo
ed love of learning.	this is stanford not
es the "nerd nation"	typical nerds don't 
holy shit	idk, if that's what 
oh really	that was my second r
e get in to stanford	pretty sure she did
üê±	so there are bounds 
the event in history	did you mention q co
an to do at stanford	idk if i was going t
ok	baking
if u have time	kkkkkkkkkk
not yet	bruh lol
not to box myself in	i saw the ahmerst ad
h my activities list	"this girl is a bit 
ya i remember that	alright, ms hession 
nice!	hmm, i kinda liked c
son's letter of rec?	nah, but carlson sai
oh	and plus if what pet
to my new common app	"modern hacker cultu
üê±	da heck
plications look like	the wright brothers 
 do u need to see it	you're fascinated wi
 from the experience	tell that to me when
t i would learn from	jobs: "woz, i'm goin
üê±	however, everything 
lmao	the last episode was
ignore that	25 - 13 = 12
t that into my essay	nvm, you're over the
wow	üê±
ok	lol i see you put hi
ey're not useless ;)	pls nu
overall	hmm, not really
hmm ok	i personally actuall
ldn't learn anything	i'm talking about hi
ly stop overthinking	when jobs tells woz 
 read all my essays?	yeh i read all of th
ok	are you going to sub
woops	lol it's alright man
e activities section	bruh
ay in a previous app	tru
theyre dumb	or they're just shot
t think it's strange	i have a really hard
 want to work for bd	lol, i wanna learn f
don't have money lol	hey hey, fuk u
good range of choice	back in da vinci's d
yup	google let go of so 
ther into one entity	maybe it's cuz i val
üê±	i mean, would you ra
 from the experience	you know what i mean
h my goals, i'm down	so that's why i don'
have different goals	i guess it just boil
üê±	that sad feel when j
t's really wholesome	and then he fucked e
is pretty shitty too	i mean the dude seem
 relatively in check	and you'll still hav
truu	all the bros but no 
ones with that moneu	lmao
from all the achools	gotta love awkward c
ead before i submit?	lo siento i was asle
 done done done done	congrats!
i forgot ur not done	üê±
probably a good idea	holy shit i just spe
bruh	how do i stop this
work on some robos?	this is freaking my 
watch some porn	i think i'll go stud
or that	üê±
s normal thing to do	just like puberty?
üê±	üê±
d the shit out of it	i feel
^link^	üê±
üê±	r u in school today?
yup	holy shit
of a skateboard lmao	no it doesn't
eeds workout clothes	bruh lol
i'm in jeans lmao	bruh
at i was wearing lol	lmaooo
 impressions amirite	buff buddies
yeee	u at the gym rn?
ou called foxy roxy.	sorry :'(
t r u actually comin	if i finish before l
bruhhh	you had pretty good 
u done with rwdc?	nope
l everyone i said hi	lol
the topic of botball	but why didn't jenn 
wdym?	the post on importan
 you haven't already	nah but it was stran
tart of the yr right	wait why are you typ
h anything different	do u think i'm mad o
unded pretty put off	üê±
re jen is pissed off	plus i trust u guys 
about what part?	sorry if i sounded m
is is mainly to jen)	nah she just feels a
und her schedule lol	she meant in terms o
ame since months ago	also if i was mad i'
o max's house? or no	er it's getting pret
e "experienced team"	ohh
*ya np	i'll have to excuse 
for a call tomorrow?	awww
about botball	idk i think i'll be 
ld call together lol	oh ic ic
ya it's kinda sad	yeh...
 ur real friends are	it's unfortunate tha
e for random reasons	oh then idk
lmao	not gonna lie
lol no	no to cover up or?
 i don't really mind	ahh
nope	bruhhh
dk why u even joined	i said i could help 
t not be on the team	i'm pretty bad at sa
bury this dead body"	"hey kid if you shoo
u still at rwdc lmao	yes
have fun :d	maybe you and jenn c
no im good	alright
nice!	are you sure you don
r our senior project	ok
üê±	drones are boring th
üê±	founds like some lib
e would b super cool	what would it do tho
pterydactyls	drones aren't exactl
mapping environments	slam'ing on a drone 
t avoidance might do	then i'm sure a came
might not be in view	yeh tru, what would 
d be mainly software	this may sound like 
 a longer-term thing	did you just talk bu
ith cots electronics	hold on, i need you 
there ya go	i mean wearable ai i
ext to bin converter	but the ai part will
ep thinking of ideas	i wanna be cfo
e think of something	üê±
üê±	yeh sure
ok sweet'	btw, have you seen j
robot with the face?	yup yup
ya	the hardware was all
qelp	yeh, i feel like if 
t is pretty cool tho	what does lma mean?
*lmao	oh lol
 niche customer base	or like
true	coming up with ideas
folder shared with u	alright, done with m
wpi?	and umich
u ready for editing?	yup yup
what physics work	lab due wed
free resp. counter	hefty amount of stuf
i didnt' k dis	didn't he tell you i
legged helicopter	perfect
? lol	you working out????
 my appointment soon	you getting mad calv
hs are where it's at	you into thighs?
noiiice	you got an eta?
probably 7:30 to 8	lol hot dayumn
a 50 yr old man dude	ahh
üê±	üê±
ive me the question?	nvm, the internet ga
can't go to ur house	üê±
what time tomorrow?	idk
working on mousetrap	we also need to make
fter e club tomorrow	ben and i ran out of
a few in the box lol	i slipped in the sho
 still need the lab?	no update from bosto
the lab?	wowow, you have yet 
wait wut	vara msgd in the cha
idk	me popular
really? why not	ben and i worked on 
fter the doctors lol	wow this sticker thi
drive me to ur house	u doing alright? par
o idk how that works	ur mom believes in g
üê±	wait u got into an a
flu like every yr xd	wat, you don't get t
important i get them	well i guess you can
 k what their doing"	wait yeh, when u get
ya i guess	alright so the goal 
build events too btw	but then i'll have t
ya that's fine	wow you're pretty se
üê±	"wow my son is final
il we arrive to help	how do you feel abou
ya	mind if i join for a
oh ok	when you think you'r
probably 4:30	eta?
so like 5 min for me	kk
ix pack of cold ones	lmao sure
sed a call from you.	 you missed a call f
ught up in something	you picking up girls
ou called foxy roxy.	https://www.amazon.c
p is all set to run?	no keys
usetrap after school	mothers going to be 
d string to the meet	idk about the whole 
üê±	üê±
the stretch problems	i'm going to pass th
wdym later?	shoulderin' this as 
welp	like passin' it in o
k that theiyre right	all of them but 36 a
y done 36 so far lol	ayyy
 i'll send i answers	you're too good for 
lol u ok?	i've been trying to 
ts keepin u so busy/	calc test, physics m
lol	:o
1_w07/notes/rec5.pdf	damn boi
applications	i'm so good at that
 on some web assigns	if we ever work at t
sed a call from you.	ah shit
ame board is out btw	this is quite the bo
ltipliers everywhere	"if ateam member is
t in the audience so	we should ask that a
ia tech wooooooohooo	holy shit what
z doenst want me :'(	damn, buzz is brutal
om didn't want me to	that's interesting t
ur in college boi	i submitted on jan 1
damnnn	yeh, it was way quic
üê±	can you go to max's?
t to catch up on lol	yeh i feel
s not gonna be an hr	i'll set an alarm fo
kinda like baymax	lmao
welp what hapoened	college apps lol
ayyy	i know i shouldn't h
at your house right?	what do you mean by 
des the towers stuff	then i think so
that's fine	do want me to clean 
n that would be good	i got'chu
lol no	in drama sometimes w
lmaoo	lmaoooooo
its all inside jokes	you can get everyone
lol	how creepy would it 
ierdos like u before	how bad would it be 
and he let them stay	lol
egged robots amirite	he and his team real
woops	i'm actually quite i
 ground for robotics	yeh
d food processing. "	i personally have do
üê±	maybe he's up there 
and we wouldn't k it	nah, we would
üê±	i mean that's some r
ulptures than robots	(small tangent, can 
lol sure	idt they would count
alion to the extreme	i think as we get cl
 able to do that yet	wait, it's possible 
heep as with a human	would you be ok with
ral or a clone of me	in general
 really random stuff	yeh
meme legged robotics	are you feeling alri
*meetup	oh, i was worried th
üê±	ooh, idk about max, 
or a 10 pt scale	thinking about it mo
 that down a bit lol	wait, we didn't get 
e we were suppose to	hmm, i do agree with
üê±	is that strat in the
wdym	is the new strat stu
g after we presented	"robots:thiccbot - 
ng for thicc butters	ok, i see how severe
 we interact with it	i honestly suspect t
r each of our robots	or failure of concep
:'(	i feel like we're un
 which regions which	do we know if the th
ed to get 2 in frame	and then we also hav
with both robots	oh wait, we aren't j
me camera work still	you know what would 
o ppl at this meetup	yeh, that's why you'
tech than social :')	:')
ull of budlight lmao	they ain't gonna be 
s the lab take long?	nah, not really
nese dudes r intense	what the fuk
is that ur goal?	there was already th
d in chapters 1 - 5?	bruh lol
ubble tea so it's ok	wasn't too informati
 network for mahacks	damn dude, you're qu
üê±	lmaooooo
s wdym is that a lot	i could spend that k
llion = 2500 atlases	which ver?
üê±	üê±
üí™	üí™
et worth aren't huge	wait, what's the poi
sure ppl s wealth by	is that how rich ppl
it's like gpa	ok, dick measuring c
 ppl s net worth are	what if that's what 
üê±	wait a sec
jk	when is robotics act
s just too expensive	i actually wonder wh
o actually be useful	legged locomotion al
ld say when we're 40	i would say 40 for w
f their not sentient	slave: "a device, or
 slave by definition	in that case, i woul
ok ya	i recall you having 
l bc dogs are slaves	oh, i was referring 
 room if u have time	what's going on??
wdym	i forgot to stock up
 long snow day ahead	if there is one anno
 cold one supply :'(	:'(
as the lab due today	jeezus man lol
what should i know?	bruh
s and basic concepts	then you should be o
it took a long time?	some kids didn't fin
long did u study for	maybe a couple hours
i haven't started	and that's what i fe
hat snowday tomorrow	judith isn't announc
smhhhh	i think i figured ou
bruh	what's a good materi
i owe u again	nah nah
<3	<3
 pic of ur notes lol	bruhhhhh
hapter 3 and onwards	so like have the not
ya	this is going to be 
are they all online?	no, i don't think so
ts the speed formula	this:
 what is it used for	its the speed a car 
lol ok thankks	i think that's the o
gonna be on the test	don't worry about th
inish the webassign?	lmaooo
 those somewhere lol	bruh lol
ular motion is there	lo siento i was doin
i bombed that test	d:
d:	where u at
ional r tomorrow man	where u at rn
 physics lab now lol	did i share that wit
thanks	anytime
did mission possible	lmaooo
sed a call from you.	https://www.youtube.
ou called foxy roxy.	here now?
ou called foxy roxy.	damn damian be sippi
not surprised	did you already orde
oh shit	somebody might've ac
bly get that checked	i just msg'd preside
wdym	ppl are asking if i 
can say no if u want	what the fuck is thi
üê±	what do you think ab
rofessional athletes	what about a kind of
easily with a jacket	it'll look like fuck
iometrics and health	who cares about that
 woven into clothing	there has been a tec
ctor bracelet thing?	nah nah
at is it attached to	let me find the thin
st like plastic wtap	it's permanent
ust led lights right	i believe so
 kinda uncomfortable	well maybe the consu
 it could jog with u	that's disturbing af
oh	did you know the goo
 factories and stuff	i'm starting to wond
ink that's mainly it	lol
g at it at all times	so you're saying tha
r visible disruption	just put it on sungl
ery day if u had one	you're talking to th
's always on ur face	if the display was r
maybe ya	if it was a projecti
when ur not using it	and it just showed u
ff after like 10 sec	but the display look
 it looks kinda dumb	http://www.bilisimca
o be warn just alone	i wonder why they ca
wdym	i think that's kind 
when it's on ur face	in this day and age 
it through a crystal	http://aiclarke.com/
ya ik	but have it project 
t it just go through	idk enough optics lo
 looks like a screen	why can't the prism 
e at for redirection	what if the projecto
tual reality glasses	technology i think i
ya i agree	unless somebody who 
lmao	oh man, i kind of wi
def as well actually	reallyyy
hmmm	what about the whole
 can control it with	is it really that de
ee the use for homes	doesn't seem really 
 i think will happen	and then robots will
mhm	i wonder if there's 
 mean completely new	but a method that is
 the telegram onward	wut about light
om0letely different?	yup yup
hmm	get this
üê±	i think electromag h
need until it exists	like fucking legged 
maybe	we don't think we ne
ya same	it wasn't like the c
nd not a big company	but were those ppl d
 jobs and only 1 woz	statistically speaki
ya	oh man, i wonder if 
mk if u need editing	i'm over on each ess
l that's not too bad	do you have any extr
no	darn
id u have write urs?	ms. hession
s everything ok now?	idk, they haven't go
 for oc what is this	lol
ade a prototype leg?	it's literally 5 pie
terms + college apps	i'm going to check i
dult life in general	that's how ppl die b
so it evens out :d	conscious while bein
h caffeine pillllsss	drugs are not the an
welp	welp
d ass fetish roy ngl	thx man
teach him some stuff	kk
houldn't take u long	ngl
wait why?	afterwards i just sa
and r u fine now	wondering why i'm no
on building sci oly?	idk, perhaps
 events for sci oly?	gud one mah boi
ld stuff for sci oly	nah don't worry abou
work more for builds	sorry about this man
's hard in of itself	welp time to learn c
 r u working on now?	i need to remodel th
*spoons	thx man, i was going
lking up to ur mouth	fuking geniusssss
arning on the robot?	to let it learn how 
y to train the robot	really?
ldn't withstand wind	damn you wrote a min
well i had econ so	https://m.youtube.co
 i get home around 7	friday night would b
not a problem	dang, coming home at
with my grandparents	oh ic ic
 ya everythings fine	this is the story
hool in the morning?	wait i don't think a
awwwwww	it's not cute!
e hovercraft came in	üê±
ut it had to be done	what if the kit just
üê±	are ya serious
welp	maybe it was telling
id mad at me now....	?
 it was just bizarre	ppl get petty these 
 really small things	it's cuz everything 
why me	idk
üê±	maybe it's personal 
welp	you know how regular
om the potentiometer	the pot has three ta
 don't burn anything	i can't wait for my 
üê±	this is all for the 
wdym	https://m.youtube.co
ms busier than jr yr	well
want to get through)	"i feel like i have 
thing but i feel bad	yeh i felt bad too, 
lol	the number one thing
come and go randomly	if you want to do th
where to carve out üòû	how about we hit the
emails to respond to	bruhhhhhhh
 other time to do it	realistically there 
 do a senior project	it might seem kinda 
stupid brains	didn't we talk about
its been a year :/	how about you slow d
sed set of interests	that's not necessari
:/	max and i have been 
sta crap ton of them	bruhhhhhhhhhh
 oly officer meeting	i really do think yo
 deteriorate swiftly	bruh you got like 5 
ng busier by the day	that's cuz you're ma
t really done it yet	it sounds like you'r
 stresses me out lol	i think you might wa
set end goal already	but i feel like a fa
g ur entire interest	like you wanting to 
m day at beaverworks	dude that's literall
 was a waste of time	ok ready for a wise 
 just fucking around	wouldn't you need to
 to do the mgh thing	and what is this rea
 diagnose alzheimers	how much you wanna b
 expensive equipment	damn, you really tho
 guiding the process	is that what you hop
kinda ya	i think you're doubt
at the axes even are	a fellow intern from
tru	(i feel like this is
nd after college lol	that's fine by me ha
üê±	:'(
get out of this funk	yeh, sleeping always
 up at the same time	well for sci oly you
thankss	and don't worry abou
hat actually happen?	i used to get sick f
lat screen it's fine	that's quite the ski
pickle right now lol	what kinda pickle? i
e to get a new order	ahh
t the order in again	oh....
thanks	did ya bring the hov
yup	what class u got rn?
latin	wait who's going to 
he hmun ppl probably	üê±
er concrete examples	oh
ya that's fine	as i review these la
i forgot to read urs	üê±
 on submitting again	tonight lol
shit	https://www.youtube.
oh nice	wanna try and steal 
üê±	man, that's like 4 u
 much does each cost	agility robotics wou
e like a private jet	i bet agility roboti
üê±	ouch
t just a transformer	apparently the show 
lol	freaking amazing
 meeting today at 8?	wat
heck the discord man	mah apps
lines feb 1st right?	gud one
n do an editing sess	you're too good for 
yes for the meeting?	yeh
hmm interesting	as an entrepreneur (
to attract customera	what do you mean "lo
om corvallis tho lol	but scott sounds lik
bout siracha lol but	cassie can be the si
economics of scale	i'll make the robots
 ppl for further r&d	i'm sure if they can
ake over or anything	yeh...
not negative benefit	i see what you're ta
ya...	also are you feeling
arted becoming memey	that whole situation
 we had a discussion	i didn't think it go
ntally argued for it	you also didn't take
thanks tho	i thought the analog
ld help anything tho	the reason why i agr
erstand the document	ppl always interpret
e "balanced, create"	and a lot of ppl are
 over and over again	so even the way you 
*if	hold on itttsss hard
lol sorry	this would be easier
ll wouldn't solve it	in the end, yes you'
t to their names....	but the point is tha
s of their group are	cuz of the order the
 problems regardless	cuz apparently some 
st stated at the top	i think the point wa
ogy except for memes	oh that actually mig
e organization right	yes the problems wil
t the top of the doc	are they so rattled 
practice lol	it's not stopping th
d then adding a list	of course none of us
ke a pretty nice guy	geezus
he was so nice	holy shit
i feel unclean	lol i doubt he would
tru	yeh idk
ya....	it feels like a plot
ill kinda mind blown	except it's real lol
ck with that man :'(	lol
to work as "escorts"	wait is that a prost
ism for prostitution	ooh
fficking is one part	i guess you can now 
iit seems stupid	why did jeremy delet
all of jeremy's work	yeh that was pretty 
re when he does work	i think max is just 
ter of his judgement	for a guy who'd rath
r intend it that way	well the truth is ju
ya .... :/	*probably just cuz
uh its stupid	i actually wonder wh
its stupid	that's actually a go
ny part of the convo	wait those two convo
y unjustifiably much	it's normal for you 
me they have of them	we're using the meme
ite the psychologist	lol thanks man
t if u want to u can	lol i was about to s
üê±	ppl are hard man
ya....	welp i better catch 
w and leave comments	nah don't worry abou
wdym	michigan robotics is
use in what context	my first sentence:
f michigan rkbtosjcs	thanks man
aren't those tiny	wait i thought we al
 borrowed from angus	lol
ong magnet from home	what if my faulty le
ore goes down to 50%	lmao
lol	btw has there ever b
ya theres been a lot	the only robo compan
obotics is a startup	but dji does drones 
started as a startup	i need more hope in 
bc fricking hardware	i think their workfo
üê±	üê±
lol	pshh
 without those dinos	it seems that andy a
actually pretty cool	25-26 bucks... holy 
for useful things	let's be honest here
 a roth ira account?	what the fuck is tha
tics is off the grid	who knows
in the war	the one where i got 
r alaska right after	holy crap
ching videos closely	but i watched all th
lmao	i'mma buy one
6 gallooooooooonss	don't tempt me with 
d 3d print it urself	wouldn't that be a b
donuts with ur money	which would motivate
or on wednesday	yeh sure
m/watch?v=u2qcd_t...	holy shot that fits 
yea sure	lol thx man
it's fine	gramps computer brok
lmaoo	uh oh
why	cuz he only speaks c
 think it's too late	you can take a read 
or grammar and stuff	i technically have 3
oh ok	if something is offs
e done in like 5 min	kkkkkkkkk
 i would try to edit	can i use laboratory
 some wording issues	<3
rself so that's good	"i love business so 
 read ur wpi one yet	oh lol
an u link me up lol\	https://docs.google.
 is pretty uplifting	but it's a song for 
tru :'( let me dream	lol, it'll be alrigh
 i finsh reading wpi	exciting
ok done	thank you so much
han it would be fine	"sex toys"
yeee	huh, i'm actually ha
ya that sounds good	aight
is still calling me	lol
just what college is	is it cuz of the aca
s the web assign due	when i was a slave o
 a thing at uchicago	i'm just going to do
nice	if that helps you ca
call home in college	do you think i call 
lol	i'm still curious ab
oh lol woops	did you forget the s
have an english quiz	lkkkkk
both are blacj	let me check
od time to sneak out	wait wut
uppose to get a pass	you can just ask if 
l retentive teachers	and then run back to
english shit to read	lolllll
oh sicc	but we also have the
ng is going crazy rn	it's fine lol
memes everywhere	wat
ot been exterminated	that's fuking amazin
why?	max and i are probs 
welp	and if you had some 
uh i can call in	kkkkkk
alk until i get home	what lunch you got?
2nd	damn i got 3rd
i left mgh	:o
be my research thing	üê±
 oly robot arm lols)	i have bad memories 
ye but really quick	we have been prototy
e u guys still there	max and i cleaned up
oh dang	turns out my middle 
hat's ur middle name	jk jk
e is hao chuan xing?	wouldn't it be
 ya other way around	or as i usually go b
üê±	oh yeh, i almost for
ya	niceeee
it's fineeeee	can't tell if you ly
duling things till 2	üê±
üê±	bruh
thing to worry about	i'm going to give yo
thanks tho <3	dayumn boii
d it for 2 questions	ic ic
thankss	alright finally subm
ur free	free after i write a
 have to do that too	really?? :o
 sure about weedtown	when i checked weedt
üê±	uh idk if that's som
t's more appropriate	geezus
 it does feel shitty	do you know why/wher
nd i outside talking	oh....
üê±	oh man
*eachother	aw
t really there a lot	wut bout mun and ven
sn't do that anymore	i guess in an ironic
pect for her as well	hmm i'm not the best
 distract me anymore	i would offer to tal
ya, that's ok	just to clear things
anxiety cocktail lol	geezus
ere still classmates	it could/probably is
ential to offend her	i think you should j
i'll just try	she actively avoids 
are blocking between	oh man i'm sorry
ut idk who she telld	ahh
shipping in spring.‚Äù	yeh time is interest
e to see petty first	sounds gucci
o thanks for the pic	no problemo
üê±	drugs r cheaper than
ya	thx lol
 you guys design it?	the concepts are dow
eys seem really weak	virgin pulleys?
e to lift like kilos	yeh...
little plastic discs	and about that netwo
re about 3d printing	if you send an explo
networking etiquette	*an explosively happ
lmao	there's etiquette??
sounds like ahookup	so is agility and bd
u should just apply	i also don't have th
then take it and run	lmaooooo
so thats a good sign	congrats!
e all back to normal	that's a similar msg
ch confuses me a bit	maybe you can ask he
to a few months	a few months is kind
lly at mun yesterday	that's good!
ok	i lied
on the way to school	nah this time it was
i'm really that dumb	i fell asleep after 
ok and a caesar book	if you give me ur pa
book and caesar book	how do you manage to
p o w e r m o v e	i'm going to break u
did u find the stuff	ye
 it up at bois night	ur pencil is even he
e top of my feed lol	that's bullshit and 
lol	i feel like smart pp
ou called foxy roxy.	üê±
ou called foxy roxy.	üê±
elina?	yeh man
damn	i'm throughly impres
user/lastweektonight	i think they need to
nope	oh hey the patriots 
ya...	shame, tom brady was
üê±	looks like angry fan
 in the last quarter	what are you talking
ya	if ya haven't done t
oh damn thanks	no problemo
make any changes lol	it's alright i don't
ya	ya ready?
ou little fucker you	bruh
 tiredness kicked in	ah...
lol	aw fuck
who is it	keziah
asks for a ride home	keziah robinson, cla
nice	holy shit she's an a
at is a) asking for?	i'm turning that in 
omeone started that?	no idea
nice	so what da ya think 
actually really cool	they fucking took ou
arable in the future	the head movement co
so that's good	but not everyone lik
ious minitiarizatiob	smart tattoos
lol	i wonder if ppl woul
nes fall out easily"	that's insane lol
how's first episode.	lmao
mmuncations engineer	fuck
wow	wouldn't it be bette
üê±	not true!
lol	wut
ya...	i can't believe the 
ally give it a watch	is it good for "what
 do entrepreneurship	ouchhh
would be unstoppable	truuu
by himself	that makes him sound
l skills unlike jobs	i like how out of al
does woz have a wife	woz has had like fou
tion as jobs and woz	wait really?
thin the same decade	is jeff bezos the sa
t in the early 2000s	man i can't want for
üê±	i guess robotics is 
super easy to set up	oh c'mon there's lik
s just too technical	tru
robots is simplified	there is currently a
wdym	oh wait
üê±	are ya home rn?
 children's hospital	oh wait you can't dr
ntrepreneurial event	you networking?
unch was successful!	ayy
ome fake dead bodies	wat
 children's hospital	they have a lab dedi
doctors and surgeons	finished
it's string powered?	just the knee joint 
 pulling the string?	the top servo
oh ic	i think i should pro
ks like a good atart	that's what we said 
m.com/50_nerdsofgrey	lmao
#entrepreneurship	here's my joke on le
üê±	alright
kinda	i just finished myse
oh ye	is mun today?
no mun is tomorrow	holy shit my monitor
and ya	when does b block en
8:23	thx thx
lol wut	oh yeh
est text editor nano	lol
on of a true wozjobs	lmao
lished is so amazing	but he never made a 
sion to work towards	tru tru
bc my phone is dumb	i just realized coll
iting ur feb update?	yeh for schoolios
damnnn	i love how they stil
 online thing for it	i called each colleg
r stanford intreview	nice!!!
tim zajic	aw man
thats so funny	can we swap lol
whos ur person?	this is her sum in l
nk we can switch lol	well on the brightsi
trying to accomplish	i now know why hurst
uy jizz in his pants	i suppose the skill 
 anyone could use it	tru
ya why?	just wondering if ya
 tryouts this friday	kkkkkkkk
p season for sci oly	nah it's alright man
thanks	no problemo
 open ends tomorrow?	e block i do
gnets in ur basement	what does it look li
n use any box really	do ya remember what 
magnet sized	lol
shiny cilinder thing	yeh, couldn't find i
ou have any magnets?	all i got are fridge
k for the box again?	i can during e block
why?	cuz idk what it look
 house during lunch?	uhhhh
i have 2nd	i have third lunch
so not ideal	welp shit
there in third lunch	lol bruh
e balcony of the caf	where u at
proabbly 11th place	lol it's alright
 i have english quuz	üê±
üê±	now that's worth
lol	how's mun so far?
why	cuz we kept abusing 
c decisions came out	nah they are rolling
üê±	it's feb bruh lol
 why it's unexpected	late march is when t
se here got an email	i thought you took b
 that bc of how busy	üê±
 few weeks have been	bruhhh lol
üê±	i guess they really 
nother asian cs nerd	or maybe ucb girl ma
lmaio	how's mun so far
's what your missing	dude i'm in there rn
wait does it work?	lmao no of course no
d the delegate dance	it's been standing f
here to work on chad	nah it's fine
cept the unviabilitu	i can't believe it h
d it be unrepeatable	meaning that when i 
oh niceee	i was afraid that it
some meme of the day	lol thx
how about "unviable"	üê±
i barely k her ok	i feel like i'll hea
nd play online smash	i was about to go to
to do curfew for mun	plus you would lose 
o sleep but im bored	üê±
weeakkkkkkk]	you could help me wr
üê±	doesn't mun require 
ed evyerhing already	who are ya rooming w
max and vara	ahhh
üê±	alright that does it
n u create the room?	yeh sure
access onlin at all?	nah i changed it whe
lol welp	one sec lol
lol	aw shit i think it t
 security than gmail	üê±
welp	alright
ok good night	have fun with jocely
dude its so amazing	that was so good
e ur messages before	how did wut go?
meeting wtih mahoney	i took notes and sha
 the same directives	what does she look l
lol	you feeling better?
just been super busy	you in school today?
yup	you wanna chad with 
so yea most likely	nioce
thanks man	btw can you open the
do u still need it	nope
t my eye is bleeding	wat
a do what u gotta do	were you guys able t
what happened?	it was pretty awkwar
ost important detail	lmaooo
not on kipr's	ayyyy
prise during e block	üê±
lmaoooo	send me some dank up
ing u the wrong way?	i think the way he t
in his ed college so	yeh i was able to co
r that triggered it?	nah not really lol
unlike vara	üê±
d it took such a hit	this is your chance 
na hang out with her	that makes you sound
:/	that doesn't mean yo
hat was ethan august	lol
lol	https://www.youtube.
your too good	why did you spam the
s a lot on this wifi	lmaooo
ally create an insta	it's a meme
lol did you make iy	yeh
ecommended it to her	wait is she going to
üê±	i think i cut my hai
 forehead looks like	yeh
*using	the second option is
ah ok	this is becoming exp
jeezus	you should sleep ear
final prep on friday	ahh icic
üê±	oh wait that works o
nice nice	you can take a break
u sure	damn dude you should
been there that much	yeh don't worry abou
ll come on wednesday	da bois got ur back
dle but i'll b there	lol nap at home then
üê±	i'm touring massrobo
ah ok	and then robbing the
mahacks meeting at 9	boi
ably go like 1-2 hrs	just don't burn out 
ok	if you're eye is sti
*weeks	it's a pretty bad si
*fatigue	yeh that's another r
 someones brains out	that's not what i wa
ts are called "dogs"	why they gotta get i
closer to real life	the writer for ieee 
lol	should i spend 20 bu
at you lareday have?	yup
ow much more precise	oh idk
oh lol	got it
that pretty hacky	yeh....
respond to jason	alright i can come a
 for mision possible	build
 what sht eschedule?	idk anytime i'm awak
r you to do here tbj	i could just do brea
;)	which part of the li
ts make it happen ;)	you don't have servo
 plenty of thrust ;)	it would need to be 
;)	the actuators would 
ss in a short height	the inertia must be 
;)	due to the fact that
g at parallel angles	interesting that you
meeting room	where's that
 u now ill come down	https://youtu.be/afu
that's insane	ikr
a i'll be there soon	eta?
probably like 20 min	kkkkk max and i have
ed code out of thete	where u at
walking	tell us if you jason
lol wut	jason said he was wa
oh shit	are you still at dav
nooe	lol thx man
npnp	that was a pretty fu
t had one in a while	did not expect to en
üê±	üê±
t with ppl and stuff	what about winmun
 nearly as much work	ahh ic ic
but after that	bruh
but after that	bruhh
shit	üê±
ever really did that	wait really
t man y other ppl go	i think i'm actually
he week before right	yup yup
 last botball season	hmm i haven't felt n
un is basically ovee	ahhh
conferences are ovee	ah yeh, everything s
ere's a river in b/w	dat's dumb
id u go to mit sloan	i want free monitors
any starbucks	but there's ppl ther
u done with ur tour?	just finishing up
ou want a ride home?	sure but i was plann
if u want just lmk	i'm taking a dump in
uh	how's mahacks
t it as last mahacks	is it near the stata
ver by north station	where da fuk is nort
ooked kinda homeless	i think he was your 
gh school hackathons	that's pretty hilari
 a respectable human	yeh ok, you'll be cr
lol	i'll just be continu
that we always go to	isn't that kinda far
lmao	is this from mun?
t k any of these ppl	or did you get so bl
troll and play along	that might be kinda 
lol	i made a mistake sit
just missed my train	wut
ye	ahhh
am members are going	this could be a good
lol nahhhhh	or maybe you could u
em to vid call me in	boi
e might be too small	how?
ll but idk about 111	bruh
shiiiiiit	that's 138.75% your 
 some ppl won't come	idk if you should ba
ye.....	could you maybe cut 
i dont think so	well is the venue go
hink they'll be fine	so then the problem 
ya	welp
think that will sell	you could have elimi
get pised abotu that	well they should suc
damn	idk about you but al
 the cs building lol	yeh that makes a lot
lol	there's a lot of you
r venue is too small	i was sitting next t
 the different rooms	ahh ic ic and you're
over messenger	that situation sound
;dlkfjasl;dfjlasdjfk	do you know your opt
basically	wait, then why are y
bc irrationality	üê±
üê±	maybe you guys can b
t do u have a slack?	i think either jenn 
 can you try to join	sure
ok so your in right	i need to get the ap
oh ur on ur phone	i ain't taking my la
get your ass checked	nah i think i'm fine
nouncements channel?	nope can't post
 all the other ones?	i'll test
sweet thanks	hold on i need to te
ts trolled the slack	the keyword thing is
ofessional companies	i just realized how 
lol	lol how is it more p
ya basically	oh wait i answered m
rketed for gaming so	üê±
 not completely free	lol
thanks	no problemo
f methods of dumping	the crank that is a 
how is the dumping?	i found a better way
 the robots function	made a new move till
t didn't work for me	the dumping is havin
ing to make it wider	the tram has to be n
i move above the bin	hmmm
ok	we're so close and y
ok	nothing is working
same	you doing mahacks st
 a bit too much time	we're at that point 
üê±	could i crash mahack
lizing our live page	what the heck is a l
e hackathon on there	this triggers me
that	youuuuu
x through the middle	i was about to say t
üê±	it's a waste to hack
rt and tool shed man	lol
 the workshop runner	cuz it reads like a 
lol	just give it the rig
with applications is	what applications do
killing ppl	she's literally a pe
k like it was butter	he just skipped back
w to manipulate them	she's just a sociopa
he perfect sociopath	i still don't unders
 be able to go rogue	it all depends on ho
pray	boi
what happened to jen	lol you might wanna 
not on a main robot"	welp
times a cover letter	the fuck is a cover 
botics just a space?	i'm not going to wri
are you job hunting?	nah when i was touri
üê±	all the ppl for the 
bably for businesses	the tour was apparen
nice	i wonder how long i 
lly really tired lol	that's good to hear 
on your resume?	ye
i would include it	lmao
welp	don't worry
y to friend everyonn	nah she's a real gir
üê±	is that a subtle pic
eir recommended list	this was my response
lmao ya	lmaooo
id u see my comment?	yeh i did
üê±	but how do you have 
üê±	ouch
early marchh	ay lmao
d and a legged robot	nah i'm not worried 
less drama this time	pi day?
but also ivy week	you could send meme 
wdym?	nvm lol
u mean with jeremy?	nah i mean in the sc
ya why?	in the time we were 
inkbi was just tired	like when you got he
o see it at some pts	yeh...
eviate the situation	correct me if i'm wr
seems to too i guess	i didn't expect max 
nts to be in control	though max does trus
 in the face with it	yeh i was just talki
regret that i didn't	i really want to let
 to work with him :/	apparently asun and 
on that we projected	in contrast to that 
 extra meetings ever	that is a really goo
be nice to eachother	a large majority of 
ya :/	or at least ppl bumm
e also not like that	ay lmao, if you ever
lol thanks man	if you need an untru
üê±	üê±
ow productive u feel	i wanna do robo stuf
all in like 5 min :/	so basically not sup
lol	bruh i thought mun w
ly work best at 3 am	i really wanna build
üê±	can you open up the 
lol ya	thanks man
for my yearbook	you could but idk if
sarah helped me pick	ha nerdddd
*bad	i originally wanted 
t put a legged robot	i'm already spreadin
lmao	i really don't know 
k about their school	but then you know th
@_@	i really wish there 
üê±	that's like a half p
cially for arguments	this sounds like an 
lol	would it really help
e it to rage about u	lol i mean if they'r
lol	i suppose she can't 
ya hopefully	and then things will
anyways	:o you don't plan on
ecifically jen and i	ahh ic ic
t my hand was a door	that's pretty funny
rd shit to deploy it	weirdd
 a massive algorithm	damn, bigshot over h
lmao	if q-computing reall
üê±	ppl with that mindse
up to balck working?	yeh, i'll just work 
ch i could come over	almost there i'm wai
op thinking about it	i may have just woke
that time for a test	may i reorganize the
're not thattttt bad	how's mun going
busy bus busy	i'll send you the ph
friday ill have time	it's due on friday
shit i have an essay	üê±
 on sleeping tonight	you aren't as young 
 jusg for a few days	my fucking linux sid
uncharted territory?	no one has data on t
hese startups before	through other events
and mahacks outreach	dang, how big is you
ans for this summer?	not really unless ma
 beaverworks as a ta	niceee
 with robotics month	you mean botball or 
botball lol	ic ic
ya sure	nvm
nice	you wanna head down 
actual class e block	üê±
üê±	forgot about that...
o starting next week	yeh sure
htly dying this week	ya think lol
ing too much already	these are backup. ju
<3	i did 39 instead of 
nice	alright i'll get tha
bitious of a product	i feel like the conc
help cure depression	idk man they still g
 at reading emotions	how would that cure 
like reduce symptoms	maybe it's just me
enger.com/t/drwoebot	yeh that's not as im
its getting there	in fact i'm throughl
:'(	how the fuk are ppl 
ry to find a pattern	that's a lot more la
yett	so it's more of a to
ya	wait is uchicago rea
y from sentience lol	well there's one big
üê±	holy shit it's a mem
exactly what it does	the one big problem 
lmao	you know the open ai
n what type of robot	yeh that's what i'm 
st so much variation	you mean the algorit
ly famous professors	do you still think t
i products in market	i mean a viable one 
define actual impact	one that will cause 
ffect on teh economy	an impact on the wor
consumer product lol	i can bet you 8/10 p
ings about our lives	econ doesn't affect 
 mass market product	i'm guessing i'm thi
üê±	üê±
 are going to ai now	energy also seems li
and wearable tech :d	üê±
it will happennn	yeh but they gotta b
be more minitiarized	idk if we can get in
in i can think of rn	lmao that would be t
iniature electronics	it's all a chemical 
st a marketing thing	it's a marketing thi
y better than others	yes
eel right about this	it was quite the sho
at's slightly betrer	only slightly doe
 the gen number? o_o	lol each core has su
like what	for example
it kinda makes sense	but doesn't it still
product is like that	and then have lesser
aries by a whole lot	each hertz counts
 to test and specify	that's like making a
ver u do with robots	ok yeh that makes se
*why	there's no way there
damn dude are u ok	interview went bette
 sam got into umich?	yeh
ally i just lie down	i think that worked
nice	how are things goon'
ng how to play chess	that caught me reall
 actualy using insta	i'm using it to post
whats her name?	you into her?
üê±	oh dear lord
 k where she's from?	ny
that's not too farl	what are you implyin
rook into her castle	castle is a move
rticipate in castles	are ya implying i sh
i wont judge	wanna work on botbal
what day is it	now that you're outt
ya sure	got any good song re
hat kinda mood ur in	idk what mood
ds tho late at night	it already sounds in
mmend the black keys	tighten up
are the ones i like	i notice tighten up 
ideo is pretty funny	yeh it really was lo
oh really? who	you'll see haha
wait wdym i'll see?	nah i mean someone a
no idea	got sent back to arc
 few ppl did last yr	lol
ho you're gonna ask?	ha nope
't prom on a weekend	may 30th is a wednes
oh welp	ay lmaoo
#corporatelife	you could ask
ust like alex turner	ikr
a bit too mellow imo	says the guy who's i
tic monkeys and that	that sounds amazing 
't even that edgy :/	are you seeking edge
 be a sharp-ass edge	lol
zy to think about it	man you're really hu
t *more* had happend	yeh of course lol
een kinda boring lol	are you sad since yo
 develop as a person	do you not like who 
well	well how about i put
struggle to overcome	i've never heard of 
 that many struggles	i feel like you migh
yes i def am	dead on huh lol
l but it hasn't been	what did you want to
an irrational desire	you fight and chase 
etal leg seemed cool	"dear santa, this ye
üê±	the idea might be co
hat i kinda realized	it might trivialize 
ve yet to experience	really? have you eve
ike a middle age man	i can assure you it 
hat's too optimistic	i don't think ppl wh
unded with radiation	the hulk did
üê±	yeh i see what you m
 him to innovate tho	he wasn't the person
es for me to develop	you know ppl tend to
uld be the best word	well let me put it k
ings could have been	i like how this all 
theme for me i guess	idk if this is a dow
mean he did both lol	yeh of course he did
er and changed placr	yeh i know you would
hat i want to be me"	yeh, you may want it
 it needs to be done	it's not binary dude
 the dream obviously	i think musky has cl
i guess bill gates	this is becoming int
er 6a, 6b, 6c, or 6d	yeh no shit lol
ye	i have no doubt in m
oh nope	can you get me one f
ya sure	where should we meet
l in the next 30 min	ayyy
üê±	üê±
e balcony tables now	kkkk
 on that japan trip?	i can barely afford 
so no?	depends idk
in terms of trips	yeh but servos
h money for that lol	no
b it during b block?	yeh but you should g
when does it end	ends at 8:20
ok	when you gonna be de
probably around 8:05	sounds good
 ur house currently?	yup
i will	dude i did some more
üê±	i also think it's ve
 crossing a road lol	built-in manual over
ere in a few minutes	nioce
here	kkkkkkk
? shit what hapoened	#i'msohumble
üê±	humblehumblehumblehu
 ble ble ble ble ble	aight, if we're actu
ld we work on it tho	i'll make a folder a
dy have a folder lol	we do?
lol ya	i think i might get 
a what?	it's a type of skate
how much are they	https://www.google.c
l and grab lunch lol	i'm at rwdc lol
lol ok	where u at
we're at toscanos	lol
do u wanna come?	nah
do u want any food?	nah i'm aight
taking a dump	bruh
üê±	stop prestalking me
by the gym	we need to conserve 
üê±	i'm going to go to t
ard worth scavenging	no lol
:d	lost mine lol
 u have ur textbook?	not sure where it is
welp	the snow didn't come
oming tomorrow night	üê±
üê±	botball for winblock
uld take like 20 min	i'll get you passes 
nk i have mrs.decamp	wait
lol	where u at
taking the bus home	boring
ar from downtown :'(	max is blowing up sh
what's happening	look at the swobo in
instant cold ones	you wanna go to japa
in asia except china	that's like every pa
alary works out lmao	i wonder if we could
lol	that snow day is loo
ick turn on the fans	grab all the dust re
üê±	üê±
which ones did u get	chris parsons
for tests lmao	alright
üê±	ez pz
wut is this musi app	idk
 this the actual app	it's basically a shi
 it in the feedback"	lmao
ly by "dive into it"	get the parts, build
oh shit right	do you mind if i jus
are pretty expensive	i just really want t
omorrow after school	money is useless if 
udget and goals etc.	the budget is whatev
d be the perfect cro	i'd rather be poor a
well	exactly
have the right parts	the right parts are 
more like 4 and 5:45	sure
its not working	yo i feel
placement in radians	jenn has pics of my 
hought this question	the radian value is 
k that will end well	as a fellow leg man 
its a sign	i'm surprised that y
ees toppled over lol	holy shit
üê±	my ass hurts so much
//tedcruz.org/donate	wait
üê±	when do you wanna ta
hmm	nice time lol
lol	you down for any tim
 wanna call at 8:30?	yeh sure
n calls now and at 9	bruh
s one with other ppl	ew
lol	still in a mun meeti
 emailing experience	you can see if peopl
ng for an internship	üê±
bout skateboard then	are you at the schoo
ya	kkkkk
'm at your house now	wait are you srs lol
no lol	you can come over if
caf in my usual spot	kkkkkk
i just forged it lol	lol
coming	oh wait i have a str
oh	it worked lol
üê±	how much trouble do 
girls and nosebleeds	lol thanks man
ah	i see you're typing 
lol	if it's comfort stuf
l hearing back from?	like a shit ton lol
lol	bruh wut
hat type of shiz lol	i feel like before i
r sci oly states tho	üê±
rics are what i need	are you feeling stre
ols applied probably	someone got waitlist
is gonna be sporadic	geezus
every weekend	that's insane
 with family friends	ahh
ya	could you get the ba
ye sure	do you still plan on
guys at maxes house?	nah
at the lib	so you can't help ou
e able to come later	kkkkk
how goes it so far?	i wanna die
be able to get done?	jk it's 9 pm and i'm
üê±	boi
ht it for me to come	alright at least we 
rind it out on thurs	ok, so then i'll clo
the barn is calling	üê±
dedicated to collin.	lol thanks man
ppened next week tho	don't think i can ev
 sci oly states prep	cuz of sci oly?
 to show swobo round	holy shit my basemen
er in the afternoon?	let's put a hard num
give me a min	wait you're doing th
at some pt today	do you have your sch
waiting on jason	if he almost died wa
ably go to his house	you're going to die
gonna happen anyways	don't say shit like 
psh it's true lol	super edgy
let's do 4	üê±
:'(	probably me
üê±	i bet max is a slaye
lol	i haven't even gone 
well same	ha
about our objectives	the first objective 
icate enough time to	 foxy roxy called yo
üê±	and it's not "life-c
of moving sculpturws	since the robots wer
:/	4 waitlists
which ones?	all the ones that ca
be perfect at oregon	lol no need for thos
e the big fish there	that's a huge lie
ed robot opportunity	jonathon hurst is th
 out of the students	and mikhail barn-man
who dat	barn-man
meant among students	nah, never overestim
 to agility robotics	the moment i do that
it just "estimating"	i don't think there 
t find anywhere else	yeh you're right abo
 to do in the future	i'm starting to thin
thankssss	sorry about the late
lly processed it yet	i'm starting to feel
how r u feelin?	the oregon project i
 to move in the ball	the ball so that whe
 dog in black mirror	moving in a ball may
ey're fear mongering	yeh cuz that shits d
üê±	actually what do you
wdym	ai and robots are al
 just robots with ai	i meant in the actua
 all ur tailored ads	that stuff has a mor
mmmmmmmmmmhmmmmmmm	remote operating bal
 i'm on the way back	fuk
tho for other events	welp shit lol
oh	yeh
welp	there was at one poi
it doesn't hurt to	for a second there i
 matter where we are	you're gay, i'm not 
üê±	üê±
r in terms of fields	of fucking course it
ols not over yet tho	and we aren't cool e
yet	fuk
üê±	üê±
test g block as well	üê±
üê±	there are so many ki
 we still need done?	mission possible
n on their progress?	üê±
ok	how ya feeling now?
hbu?	i feel a lot more co
 with ur skillset rn	i wanna make one fro
nverse kinematics is	electronics and all
üê±	but surprisingly the
 load correctly lmao	i think we should fi
efresh to try again"	now that's a good er
lol wut	what savages are our
i hope	https://spectrum.iee
 was a hitchiker bot	https://www.cnn.com/
well phily is trashy	i know why the grasp
gs and that's normal	did you just assume 
interacting with lol	i mean if a kid take
ah	shelly the turtlebot
 the future are dumb	i feel like you're a
ent and can't suffer	üê±
üê±	jk i have the sentim
 animals have rights	you wake up one day,
teractive version...	i think it's more li
 it really annnoying	in a survival situat
ya	why did you add it t
ye cuz its catchy	i also would like to
teach the robots rad	but then it'll fall 
true	aight, so you're not
can stay pretty late	aight party at my ho
have it due tomorrow	üê±
yo roy where u at?	doing work
s the mousetrap here	probs 5?
ntal design practice	k i'm at my house no
lol wut	it fucking exists
ou called foxy roxy.	washu in bumfuk nowh
she said yes	if she tries to kill
lol	does this mean you'r
yup	wowowow
lol	are you sure you can
2nd steve jobs movie	the better one
steve jobs movie lol	2015
you already saw that	nah i saw the first 
 ashton kutcher one?	yup yup
http://bit.ly/h2v...	what the fuck
reating the position	üê±
ild team on schedule	wait i didn't know t
l the parts ordering	bruhhhhhhhhhhhhhhhhh
ts at regional meets	where did this exist
 on each build event	can we do a call? my
lp im not at home rn	family event right?
*quiet	ahh
nah im not lol	when you're chewing 
oach to build events	the best position sh
 store materials tho	the 1-3 ppl who are 
ther songs are good?	https://www.youtube.
or negative purposes	i mean the lower cla
t gonna comment that	i would argue that t
m instagram comments	my toilet is too com
at 4	https://docs.google.
ta that we collected	damn bruh
 down online gym :'(	bruh
ann9t take gym or pe	bruh
üê±	that's why you're my
üê±	lol so much for ai t
efore and after that	you also was able to
check mark each time	you could start doin
i promise :'(	lmaooo
yaya	tears you left me on
lmaoo	fuck you responded l
lol ya too slow	fuk, you responded
a's got the practice	i'm not fast enough 
he just snipes	master at his craft
woah how do u check?	that's more than i e
nk thats iphone only	ahh ic ic
lmao	not skilled enough
üê±	shit man
probaly be less cool	itll be boringgg
s with flamethrowers	holy shit
 l e r   r o b o t s	"dark side"
tape their test runs	they do have blooper
robot marriage	we'll both probably 
 graphs on this lab?	yup
e a few min ago lol)	holy shit
thankss	no problemo
:'(	bruhhh
 to do a final check	i just passed it in
just got a pass	üê±
üê±	shittt i'm really be
did you die again	i'm fucking hyped
s more psychological	lmao gud more, docto
den of consciousness	i worked out with sa
a doctor i'm serious	i'm also having a ha
s happened for weeks	that's a new progres
lay it all out	i don't think there'
r of school would go	no lol
wdym"	when i thought about
have any beforehand?	idk, i don't have a 
s imagining it to be	i did apply to some 
ajor projects right?	i don't recall any t
i'm just spitballing	i didn't really expe
esources you have rn	it's not practically
lmk what i can do	i have rwdc after sc
üê±	üê±
han hurst or raibert	idk, technically spe
ing on the venue lol	the westin boston wa
lol true	i know technical wis
rdinarily remarkable	there's a japanese d
t college experience	doesn't say on his b
bly before u turn 20	it's easy to do when
makes you remarkable	maybe it's just rela
 in mind the context	it's probably a left
you artsy cuck	lol
afuq is claude monet	https://www.metmuseu
its a bridge	"bridge over a pond 
raw better than that	oh shit i just outte
 be staring at paint	i know i shit on ste
apply more to you rn	haha oh man
many hours in a day.	we're probably going
its soo good	maybe it's cuz of th
elf (if u go to osu)	yeh you're right
t old man, its 12:00	we're basically the 
 feeling better tho?	yeh
i could start ai now	i should stop thinki
 think u can do both	haha thanks man, but
packetting and parts	lol thanks thanks
gnight :)	wanna work on chad b
d to finish a mathxl	aight
date in the discord?	i need to finish tha
lol	mkkkkk
nah got track noe	ewwww
nd half of the block	i wasn't able to get
ptsd	i'm going to go down
sounds good	pressing spot and do
dn't fix the problem	ay lmao
ly fixed the problem	ay lmao
yet	to make legged robot
that's good	their main applicati
tube videos thus far	yeh that's true, agi
's company goals are	they wanna make dino
a marketable product	everyone is a cro at
rst got a job at osu	that's pretty insane
any movie recs	steve jobs 2015
ok	wait
lol what	lol don't worry abou
r the part i watched	ahhh
bout to get on stage	oh man that leads to
his whole life story	yeh it does paint wo
s reinvited to apple	i do think woz was c
you should comeeeeee	hmm idk still
s are u looking for?	internships with mon
what u wanna be doin	yeh robotics
its radial analytics	what the fuk is that
nd autnomous racecar	but i wanna work on 
wn exploration in ai	yeh i wanna explore 
lol	i'm a choosing begge
 u applied thus far?	i forget
or apply	that was apply
have u heard back?	heard back from the 
tell jen i said hi	she said why
üê±	nah she knew lol
lol oh	how you doing
nervous bout what	oh nvm
not to go to mr. whs	you probably should
izes jobs a lot more	lo siento i'm still 
lol ok	apparently there are
econ test as well so	wait there was d blo
oh	wait shit what day i
what day is it today	i just soent all my 
its day 2	bdcgf
*bcdgf	doing rwdc until 1-2
 are really grinding	my ass has been grin
üê±	üê±
ya sure	i'm on the green now
all theway back door	lol
lol ok	every single post in
th legged robot pics	i would be ostracize
show them who's boss	why is hurst there
who's nerd boss	hursts' lab is full 
huh	yeh i got nothing lo
lol	actually, one common
% asian, not too bad	that's a lot of hisp
ven put a percentage	i don't think i've e
est coast in general	8% essentially
ye	9.1% ethnicity unkno
probably	oh wait then i think
o 50/50 gender ratio	is that supposed to 
ith the gender ratio	let's be real doe
true	boiiiii
uhh mun shit	üê±
lol	i guess i should cha
üê±	btw this stuff clock
y bought everything?	when i said i bought
you owe me $569	üê±
conference in europe	if it's not at eth z
welp	unless it's from sof
ed for opportunities	the only legged robo
it would be so fun	same
ya	you down for d block
 need to redo a pass	üê±
st the other one lol	how did you do that.
actually really good	yeh dude
do #2 on the mathxl?	we don't have the sa
t i meant web assign	gonna have to get it
*midway pt	thanksgiving
ctually nvm i'm dumb	wait wut lol
nothing	https://docs.google.
y shows your passion	holy crap, you read 
ve feedback on those	lol thanks
and intern candidate	oh tru tru, "i've he
 summer job type ppl	no way
 to do legged robots	how could ppl be wor
sion control systems	oregon kids then mus
ccion for experience	bd, schaft, etc are 
ews about them today	ok then i'll talk ab
nice	you still at the scr
done until like 6 :/	ouch....
what drill?	ben said that you ha
d any news for ivys?	1/10
?	i used to bat 1/8
ah	this email to hurst 
ah	actually i'm about t
why?	on the chance that h
 fucker who emailed"	oof folks got mad at
oming off too strong	yeh that's what i th
ike watching a movie	yeh sure
re light hearted one	lol
ith samuel l jackson	then there's a beaut
ramic animal as well	they generate the be
make up a latin quiz	you were marked abse
welp	maybe you can get it
x out those absenses	üê±
just fell asleep lol	niceeeeee
that's disgusting	üê±
d to go comfort vara	i have physics a blo
etty hard by college	didn't get what he w
5 reject/waitlists	holy crap
ye	so many ppl are depr
ya....	lmaooo
üê±	it's almost official
 meant for the hurst	i've been denied at 
ably got scared away	rejected from berkel
? wdym	i'll tell you the wh
of college decisions	yeh it's partly abou
u still waiting for?	cmu umich and weedto
cmu?	üê±
fect for u every day	what makes you say t
üê±	geezus
osition to stand out	it's just a bit dish
no recording co l...	i like how we have s
ye	and really thanks ma
yy that's the spirit	i still just really 
i think so :/	how have you been fe
 and enjoy senior yr	tru tru
 chris ethan and jen	chris yang???
i think so	awww
eciding northeastern	ah ic ic
ya i feel	it's also just a bit
ya unfortunately	and to answer your q
ya	https://spectrum.iee
ey get money tho lol	idk actually
e u even practicing?	the street
ok	üê±
do u guys come back?	2 am
lol i wonder why	it's insane
 got rejected lmaooo	shit
from who? lol	sam
nly read the caption	yeah i did
o how was anime con?	it was actually pret
are you still there?	nope
lol ok	the college decision
have one more right?	hurst still hasn't r
ght u applied to cmu	and the only one i w
ah	i wanted to visit an
m to reply to things	time to email barn m
lol	jk, probs going to e
iorities = black ppl	thanks for reminding
sorry	lol
aming technology,...	sure you can ask me 
urnaments at cpw lol	cpw?
*sporcle	what is cpw
for mit	ahh
 the one mr. b loves	lol alright
nerdy stuff going on	msg me when the part
ost nerdiest way too	how did they do it?
cument, very chaotic	geezus
nah it was a groupme	ahhh
ould totally do this	i showed you that be
oh wut	üê±
 out a few weeks ago	the design was made 
 would u use tho lol	beaglebone perhaps
copy of google glass	if you really want w
arable tech projects	lol that sounds fun
 materials and stuff	though are you sure 
 make such a project	i mean when you're a
o learn some lessons	yeh perhaps
ow is that goin btw?	i can longboard kind
rojects and learning	idk i think in just 
:/	it's hard to believe
 all your waitlists?	i can't send a lette
our other waitlists?	i'll see how hurst w
ceptance rate is 51%	lmao my "safeties" k
 smash will help lol	i have 5 tests in th
ition was april 22nd	üê±
ng out on april 22nd	there's a presentati
ah ok	maybe i should go vi
iting weekend right?	and you are honestly
 u should be all set	i also first thought
really ppl do that?	i notice that ppl te
 person brings it up	but this time, self-
g april 6th and 13th	they also can't fly 
who's they?	osu
wow	gotta find some sand
or the ticket right?	probably
0-degree experience.	i found out about my
eam of legged robots	yeh and i really app
just enjoy senior yr	you know what's cool
hey're totally valid	that's true i suppos
know u better do too	i can't say enough h
t emotional shit lol	i suppose the last t
s than ur background	haha they say that y
lol	ahh ic ic
more about da brands	guess i'm lucky to b
üê±	but i'm sure you kno
an vibe with so well	and here i was think
üê±	lol
lmao really	yeh dude
step aside mike	lmaooo
yup cya	and yeh if you wanna
ok	wow
 for u if u need one	i need to study for 
ake too many changes	sounds good
with christoph	nah, i have to study
an work on rwdc here	it'll be easier with
just come to eat lol	got more tests tomor
seniorrrrrrrrr	it'll look bad if bo
 if u change ur mind	haha thanks
/watch?v=xagxwuwqopa	that is propaganda b
ence to support rhat	but they keep showin
 with it responsibly	yeh i feel
rents to let u visit	nah, we just absolut
ah ok	i need to find a cop
st bet is used books	or the trash can :'(
üê±	this doesn't feel ri
t doesn't feel right	do i really deserve 
 u to visit his lab?	at this point i thou
 osu it's gonna be u	probably should go f
r such enlightenment	i'll go down that ho
eed to find ur tammy	i'll be rooting for 
 have dinner with me	but have you ever ev
lol no	don't worry
ppl are horny af	japan already made p
pl with leg fetishes	i would end that so 
y i would endorse it	holy shit
imarily the hardware	vr or ar could reall
why?	sarah asked if i was
 going after sci oly	ooh ic ic
ye u should come	is k here today?
n lit assembly thing	kkkk
here during winblock	here's a progress re
ok	i'm not sure what we
sistent in which way	i also fiddled with 
uh	maybe the arm doesn'
ok sweet	there's been an inte
wdym?	nah i just noticed t
ot fucked in the aas	where you at
physics	i'm in the hall
ot fisted a 2nd time	üê±
 still skateboarding	yeee
nically in e club rn	you wanna be cool ne
where r u rn?	almost st the school
ed me to open a door	i'm behind you
 in the botball room	bruh lol
smart choices	not many places will
hat you'll get there	unlimited resources
accountable for them	jk jk
ecide on camille? :o	iman's been bringing
mille already knows?	and then i said i wa
that direct approach	holy shit, da heck b
as fucked up already	i was also kind of h
 prom it's no biggie	yeh that was my conc
h end of may i think	oh after we get out 
no actually may 12th	maybe you can get th
jk	don't do that lol
ooh actually ya	i bet that'll be nic
 the slow dance type	that's a real good p
lol ew	can you forge me a p
ya sure lol	wait jk k is back
i'm at botball now	stairs are going to 
oh what	i got a call from th
damnnn son	so i heard, are you 
whats the company?	should i call again?
ey just called u lol	both
hmmm	i think i'm going to
ok	oh shit it's confirm
e your interning for	she didn't say which
or just the banquet?	lol and here i thoug
 holding the banquet	afcea
üê±	looks like i'm offic
ty of parts to steal	really? how big are 
ernment and military	wow
when the banquet is?	lol that would be fu
fcea gala on may 5th	lol you're fast at g
 the d a r k s i d e	üê±
lol	you at the school rn
t working on chad rn	aight i suppose i ca
what talk	https://events.atten
or the first mahacks	wait really lol
 idk what it's about	there isn't much inf
 of track that early	you can say you have
ady made that excuse	maybe say you're fee
dy done that one lol	apparently my folks 
what	what is the time fra
how	idk my pops just wal
*werent	oh wait
lol ok	jeffery is my cousin
ahh	he's our age, and is
nts in northeastern?	yup yup
me up out of the blu	oooh ic ic
fribo	nah dude it's not an
or ashley in chicago	wanna make one for h
es" it can recognize	idk
//joelgustafson.com/	things were cool unt
here i'll be staying	holy shit you're goi
dicted my intentions	maybe that individua
l lose individuality	the moment that ever
re objectively false	that's true, but the
that is really scary	isn't that an ideal 
tion of the internet	but google's control
thanks :'(	not a criticism and 
intell	(i wouldn't count bd
ne mit tech startup?	"intel was founded i
rs were grads of mit	lol wat
ups until like later	if we are talking ab
buzzfeed	buzzfeed?!
khan academy	idk if you wanna be 
ecame full companies	very little
 was still a student	the original databas
 you know in general	i can name you a shi
ey're very succesful	https://www.youtube.
igh profile startups	and they also had lo
y make a huge impact	that brings up an ol
carbon nanotubes now	(btw that article wa
like elon musk	this joel guy is qui
actually make the pc	yeh exactly
ing back to my house	welp shiz
really want anything	once i get my first 
ing except cold ones	a shit ton of cold o
really need anything	how about
ccion money in there	some people wisely s
 sense for long term	you think i'mma live
mall and i'm so lost	why are you at the m
 be able to slip out	you can say you have
ht get really pissed	perhaps you can be l
but i won't lol	if you don't mind (i
as fun just got back	wowow
thes not from costco	holy fuck
ore of a friend date	what is that suppose
ya i'm heading back	üê±
?	the company i'm at t
oooh	he was an employee, 
gonna be doing there	nope no idea
thanksss	we'll go grab some c
sounds good	i'm almost done with
s i could borrow lol	yeh but where are yo
back from field trip	when does the train 
2:43	otherwise we can swi
do u have class rn?	i'm in math
or the rest of break	would you be up for 
ching pants if u are	wait my pants aren't
r house to grab them	my house is locked l
oh welp	i think i can skate 
 run back and get it	if this kind of stuf
tra pants in my frat	bye
üê±	btw
rn	extra pants that the
üê±	yeh i'll just be ska
 friendly discussion	lol
the pants in advance	are you on the stree
ok i'm there	the street?
walk toward ur house	holy crap i thought 
lmaooo	i'm lost already
oh lmao	the organizers and r
fect networking time	they're having a con
d introduce yourself	i'll wait until they
? how	oh wait not turned d
rely anyone is there	crap there are so ma
ying to talk to her?	yeh lol
welp	there's like 5 ppl a
ll get her attention	what if i get reject
lmaoo	hmmm
really? why	the moment i did the
ner apps on ur phone	oh smart
üê±	tru
fuck you	did ya finish the we
sshit	here you go
 there are 3 of them	number 5 isk = 23/
ing for an extension	yeh lol, it's a grin
lol wut	ppl are harassing ro
 be kidnapped at cpw	wat
xt day how it goes"	don't do drugs dude
nna get kdinapped ol	where does buzz find
that technician	"these gloves are no
n saturday night lol	wait are you serious
ofc dude	aight
eetings%3a%3ameeting	i mean there are 2 w
does osu have frats?	idk actually
üê±	üê±
i'll check them out	zeta psi huh?
isn't it godfather	reservoir dogs
ah ok	or maybe it's goodfe
painting on the door	lol nah man godfathe
ore quirky than most	idk why i keep assum
 no hardcore parties	so i shouldn't come 
üê±	that's a tad disappo
ya it's a nice frat	ahh ic ic
bout to go see atlas	i've never seen a ba
from the leg lab lol	holy shit what
re so he did an urop	they're like the hal
üê±	skating makes you mo
it forgot abour that	it's so nice today
girls left and right	i don't think i'm do
slayin them too hard	also this book propo
that's today at 10	yooo
 of the ragers later	the 10 thing is supp
dk it sounds like it	did alexandria tell 
he bros of nu delta"	who knows dude, mayb
t went until 4:30 am	"inner panther"wel
it was sicc tho	tangerine?
 top of the big dome	oh wow, so you got t
u could totally come	lol, aight whenever 
how come?	rwdc, which also lea
icing presentations?	there's a lot to pre
need to catch up on?	i don't even underst
well thats normal	normal isn't the goa
i cant come today	wipe that smirk off 
ok thanks!	there's so many new 
 uh how about like 8	sounds good
üê±	no ones here lol
o botball afterwards	i heard the mun meet
't think it will tho	we've just had our b
ouch	üê±
ts happening to chad	i'm going to kill my
üê±	wait
g to the mun meeting	ohhh
me if she heard that	meet any ellies at m
lol no	wat
her again at visitas	lol
d meet up at visitas	boiii
üê±	üê±
e first people i met	destiny?
achother well enough	i'll be your wingman
^link^	wow her last name is
 going to hackathons	this is too good man
r u doing in boston?	ros meet
sicc	if you wanna come yo
ll pass for this one	whoa
woah	should i submit this
an u could if u wabt	i'll fucking due the
üê±	now you just have a 
s not goung shopping	oh
like her in that way	just really close fr
*close	so who would be a re
ya	üê±
d reason to be awake	are ya just chatting
ya lol	go get em tiger
mainly girls lol	lol
:'(	are you just feeling
and it went to girls	here's some not supe
hen ru getting here?	shit
is really creepy lol	geezus dude what are
for winmun	ooh gam i i
wbu	gambino
lol	this was the song fr
 that performed this	it's probably cuz i 
lly my type of music	ahh ic ic
psh im fineeee	are you just thinkin
don't feel tired yet	that could be all th
oh wut	ikr didn't expect th
lol he's salty	chad can pick up bot
lol only 70% meming	...
ing senior assassin?	it's not mandatory?
water guns mandatory	maybe i'll do it
er easy to get u ngl	what happens after y
your target's target	ooohhh
$20 from ethan	are you serious
ectronics everywhere	üê±
üê±	you're doing it?
ya	i honestly probably 
ound harvard's robot	holy fuck only ten
how's rwdc?	we finished
üê±	she's 20
damn	she also got rejecte
she a cougar?	even after working a
w that's really cool	her opening line dur
damn	just woke up complet
its spicy	max and david msg'd 
no you're not	üê±
who do u have?	what advantage would
h most of my friends	who knows though
have caroline conway	lmaoo dude you're go
ya lol	idk how i would get 
hmm	oh wait nvm
 bc shes someone u k	friday i have cyber 
nicee	is senior skip day o
actually id	eh that's something 
no why did u ask her	just to confirm
 shouldve asked mark	fuk tru
she suspects you now	nah she basically kn
üê±	welp oops
someone gets you out	i'm usually in the s
 close to the school	yeh that's tru
s the girl a pothead	she lives in cali no
is she from texas	pennsylvania
e to do them tonight	üê±
the ones due tonight	there's also one due
shit	don't forget to talk
e a bs  progress log	ayyyy
nto every market lol	feels like they're t
 company than spacex	really?? i thought t
ya they can't yet	is it really that go
 owned by jeff bezos	is he just trying re
is older than spacex	then what's his goal
ter in less time lol	üê±
rbital space vehicle	wat
n response to spacex	poor bezos, the medi
ya	do you have track to
who killed u?	kate ryan
confirmed	who da fuk is shane 
ol he's in our grade	i mean it is called 
 snuck into ur house	lol kind of
pl going to ur house	feels bad
wdym	in an email they wer
 i'm coming down now	got an eta?
t this just happened	holy shit
so he has fcharlie	ahhh
ssengers in the back	hmmm
jeremy can	aight
i'll do it	sounds good i'll jus
ick up stuff as well	you know the wheeled
/watch?v=g0tayhjpofo	every human on this 
legs are creepy af	that's only if they'
 still pretty creepy	the wifi is so crapp
üê±	i wanna meet someone
nly for robotic legs	it's not a fetish
for humanoid animals	no that's different
m more than our will	we can't really just
l over other factors	but what if the othe
üê±	i woke up not too lo
kip and come with us	nah i still promised
an skip both tho lol	that's a lotta skipp
ior yearrrr enjoy it	nah i just don't wan
time with the boiiis	i gotta manage my ti
ou called foxy roxy.	wait a sec idk how l
d games after school	i haven't seen her
:d	congrats!!!
 there will be blood	duuudeee
e leaving afterwards	yeh prets much
at's the work thing?	holy shit the connec
lol	hmmm i hope i didn't
e same price as osu?	it's definitely not 
ig hookup from hurst	so you're saying the
 and agility as well	what would i explore
obotics stuff at osu	nah osu is the stewa
more viable-- fields	i thought that first
üê±	but that wouldn't ma
tion if ur in oregon	are friendly email u
ot the same at least	yeh the connections 
legged robots at osu	you saying that i'm 
ian aadhya points at	i have crazier hair
he same thing as you	is it because there 
opposite at nu	that's a good point
 also better than nu	bruh you should know
t can hook u up with	if buzz says yes we 
lol np	that's the scary par
e into legged robots	yeh good point
lol zame	who would've thunk t
and ros	yeh right lol
stay safe!	i can't find the ter
?	it's rather empty he
the what	wait oops
 better meming me rn	i am not
ru ok?	nah
ah ok	ok now i'm memory
oh gawd	oh there's more peop
üê±	hmmm
at echo?	yeh
ike the main sponsor	what the heck lol
eated about that lol	was i? did i?
ray rays	what do you think ar
an massachusetts lol	damnit
same thing	luckily it's not a c
üê±	sarah where u at
ke the study session	üê±
lls at me anyways :(	she said vines
 for like 30 min lol	you have a curfew?
ts want me home theb	i never knew lol
üê±	are you actually goi
 we can get in on it	well there are some 
e's a big difference	cuz the end result i
rip	that's insane lol
ame size and caliber	is it really worth i
lol	which school is wort
n about 5 - 10 years	you know i don't car
e their life quality	i just care about wh
lol	but i don't think th
üê±	srs though
lol	is it really that am
o much at face value	but i'm a one sided 
est field to look at	i think that's only 
t worth for robotics	lol we just reached 
 make a full opinoin	i would say the robo
ities at the college	the psychology major
able to make it back	hmmm i don't know en
,000 starting salary	but what field thoug
ield, just by degree	all the generalizati
 a median of $35,700	üê±
an average of 82,000	above 35k can still 
is probably like 45k	ok if we meet a supe
ly stanford students	but as long as that 
r part of the school	minor
lol	jk
ficiency in robotics	you just watch me @_
üê±	yeh but oregon is ma
st deal on your weed	lol
ine i'll do it a lot	*flash forward five 
i might pull a gabe	that would be insane
to finished products	leaves delivered by 
üê±	if control theory of
 the argument for nu	what was the argumen
der range of options	wait, what do you me
f study and research	you mean majors not 
üê±	pshh
 old botball captain	oh shit i read that 
and a masters degree	wait shit what
ots are kinda flashy	are they really that
inexplicable reasons	i refute that adject
üê±	i gotta say
but the 3d tour	üê±
lmao	i'm literally bankin
good places to board	problem is what woul
u beat me	lmaoo, that's pretty
bad in what way?	his reasoning for it
g collectively rises	but isn't "equality"
üê±	hmmm even if the wag
 robotics conference	bruh
turned in my ap form	wait so you skipped 
o miss the countdown	not gonna lie, i do 
e last day of school	then again i thought
üê±	idk why, but i've be
 thought it was fine	wait wut
traight line, i'm ok	bruh
:'(	i'm stuck on 2b rn, 
t to feet per second	it's an itch that i 
 is why we're single	motherfuking answer 
lol	did you get around 9
i got 8.889	lmao fuk i'm on my l
just to check	yeh sure
stance = (1.) - (2.)	lmao i got 13 feet
yup	so for velocity it w
yup	fuk it really is 13 
hat are your numbers	nah it's correct lol
lol thanks	this is another indi
üê±	holy crap i forgot a
you filthy foreigner	you're not wrong
 a 3rd world country	damn
t think thats normal	lol i searched it up
ire body checked out	psh
cise would do it tho	maybe it's due to de
üê±	https://www.theverge
uld properly respond	bruh it's fine lol
thanks lol	i got'chu bro
üê±	i gotta say though
u actually tryng to?	i should try to be m
b at shakespeare day	thanks man
coming again d block	i'm going to lose my
n china on june 14th	june 14th to when?
june 10th to 17th	oh that's good
oh for botball	yeh my voice is done
woah what	yeah i thought you'd
ps for robots right?	yeh essentially
of phones these days	yeh the internals wo
bots instead of toys	can you imagine that
or dinosaurs	tru
sed a call from you.	yes i'm still home
feel better!	did you guys come ov
 already downtown so	ahh
to get into ur house	when i live by mysel
lol in ur tin hut?	yes
than what u have now	maybe also a camera
 sell a lot of those	what really
also u sure ur ok?	i just wonder if tha
still alilve somehow	they haven't actuall
and played cards lol	shiz
s will be way better	ohhh
ach day of this week	da fuk
house is like 30 min	you live so far away
 what's in my fridge	i mean real food
e plants in the yard	lol
n't need a lawnmower	i feel like that's a
wow nicee	this is before i get
e daniella rus event	yeh
you seem bitter	just a bit salty
 small and connected	can't tell if that's
llege is for i guess	lol you'll become an
not ai related	da heck is multi-sid
 between two parties	are you becoming a b
er, airbnb, facebook	üê±
g more prevalent now	oh wait i didn't eve
 not for that reason	facebook reduces you
multi-sided platform	it's not?
ers of that platform	like the bois provid
lmao	but what significanc
raditional economics	sounds like communis
ike communism at all	giving money to peop
egularly go to space	ima red blooded repu
acex is really smart	really? despite all 
repreneurial miracle	i argue that a reali
forgot legged robots	what parts were bril
r physics at this pt	lmao no
 of the rockets work	be careful dude the 
lol	but how much does he
e he's a businessman	really? doesn't that
jobs?	oops
 has to say helloooo	well gates technical
actually act as ceos	oh tru, it's not lik
ies suck at business	yeh but you gotta ke
owning upon business	if that was your onl
appoints the cto lol	maybe i'm biased but
i mean	with a more specific
s not the tech world	what
ou i'm gonna do both	lol who said that sh
vard faculty as well	well shiz they just 
i haven't checked	i think it might've 
robotics conference?	nah day before
happening there tho?	nope
*pre-event	time for me to flex 
half of the marathon	you know what would 
wheeled* sheldon bot	is that a big bang r
just checked	whew
be like for everyone	so it's 100% ok to a
on't miss any movies	ayyyy
ell be eating dinner	perfect timing
nice	getting to massrobot
where is it?	gotta go through the
ywhere in boston lol	yeh but the bus?!
h u alone on the bus	lmao
t u have a phone now	i'll just use my lon
 	it's just french for
wearable tech :d	hmmm
nly music for robots	exactly
? for booz allen?	yes
it's about 44k	wait really
in a yr	lmao
l make u feel better	yeh that's my favori
x amount of sunlight	exactly
üê±	 you missed a call f
/ r u ok	it's bigger than i t
bruhhh lol	nah i'm probs not go
hy legs are unviable	well maybe if i just
üê±	that would be quite 
ya sure	do you have an eta f
ving me to ur house?	yeh we're in the sam
or to echo	we need to be at the
emily lee	nah ten
farzana	9999999
and emily up from 99	what
ulu are picking u up	whaaa
i'll send vids	here ya go from toni
hat drunk me is like	feel like you might 
and edgy	really? bitchy??
i start roasting ppl	really?
lol maybe	where you at man
going to school soon	aight come by e bloc
ere did everyone go?	i'm in math with som
tually went to class	yeh i did
lmao	i think you might ap
 sending me ur scabs	to gross you out
 nee.d that. imagery	you're welcome
w r u going to enka?	shiz what
ya it is	think imma head home
did u get that book?	lmao i wish
of art historians	so like 7 bucks?
üê±	aight back to readin
tational linguistics	no i'm into computat
woops that was mean	holy crap
üê±	i'm guessing you can
hats lame about that	that's kinda lame br
ow shields harder so	how is it funny doe 
but its still funny	yeh but captain amer
and he's funny	his power is to be s
 space between atoms	that's not how atoms
hysics shit and boom	you can't reduce the
üê±	ok that's true lol
or shoot lasers	yeh he's not black
 can jump like 20 ft	holy shit what
off and destroyed it	wat
ok	shit
hrough julia's party	lol
whenever ppl leave	should i still go?
once i finish mathxl	wanna show up as the
"fashionably late"	do you have a ride t
ood for the marathon	do you mind if i hit
on't wanna stay home	oh yeh i still need 
ure u can get a ride	thanksss
it's due tuesday	lol
ad shit into the car	yeh sure
be there in about 15	nice i just took a p
u coming?	just woke up
ru coming?	leg day
es we all hate u roy	it's a fuking feast 
damn	grilled chicken stic
 yours i don't think	aight
 to order ur ticket?	yeh sure
probably will be too	aight cya in several
more thanos is right	there's a reason he'
 interesting villain	whatcha talking abou
actually makes sense	üê±
hardline utilitarian	i think this quote s
üê±	not cuz he's a villa
orrect to kill 5 ppl	if there are 5 ppl r
at, killing is wrong	yeh that would just 
rianism is all about	but not everything i
u maximize happiness	his plan didn't have
efit in the universe	cuz rn it's weighing
illion miserable ppl	üê±
ow cuz i gotta sleep	when you can cherry 
 really cool villain	but in practice it's
to make a judgement	lol yeh you should s
eep now cya in 4 hrs	good night man
left your house yet?	almost
like the showcase	not sure about that
a little before then	alright
and leave now with u	lol
i think i'll be fine	alright so i will co
what's ur eta?	need to drop my sist
 an alarm for 10 lol	that's not 10 o cloc
lol ni	there's slight morni
ng should snooze for	five
r u outside?	almost
o funny in this room	more nerds and way l
ressively automating	like art history?
rian might be useful	pay day for them lol
he same 3 characters	sounds perfectttt
lol	holy shit dude
wow roy u perv	i did not mean to do
bruh	i feel kinda guilty
guilty it's all good	holy fuck
how is day 2?	fucking great shit
or that to be useful	or underwear that ca
genius	you think i may be k
our piss into energy	piss is hot as shit 
er filtration device	or
filter in your pants	but your pants are t
google science fair	yeh
or just running	sam and i sprinted f
esn't come naturlaly	oh don't worry dude
safety message first	safety messages are 
andom shit naturally	yeh
 miles from my house	well ppl like it whe
 fat over the summer	you should def do th
en it was about prom	lol
 messenger that much	i mean to be fair to
o that kind of thing	yeh ppl are surprisi
hrowing shade at her	lol
ya basically	i feel like we will 
nting but not liking	lmaooo
 fat number of likes	what is that emotion
ya	i wonder if it would
the importance of it	perhaps stuff for ge
es suck at marketing	*not perhaps
just posting a video	what exactly is mark
prove in that aspect	cuz i know examples 
lmao	oops we were thinkin
 marketing and stuff	well you could devel
lol	preferably a girl wh
üê±	aka sarah -> singula
mmunities at harvard	yeh i'm starting to 
like amazon	but i would argue th
ok then apple	well now they got pr
 for shittier phones	but their biggest ad
ntire brand strategy	from my knowledge on
rketing case studies	that their ads were 
ble branding content	so you're saying tha
robably with roombas	and youtube videos
üê±	but haven't you noti
at harvard last year	they did?! but justi
teams if mit's sucks	the connections with
stance on what?	whether or not that 
out where osu is tho	it's in a forest
the atmosphere there	yeh that's true
they are from cities	don't you hate how m
lol	you're up early
and i'm sickish	damn how you get sic
me minor sore throat	i would get you some
lmao	oh the woes of trans
e of bumfuck nowhere	hey you got uh
lol	lmao
feel so unproductive	but what do you have
tching up on some ai	i feel like at least
 done except botball	dayumnnn who are the
 on an advisory role	what do you advise t
e parents take notes	lol
r for me to help out	cuz you won't be in 
oard of youth cities	so you saying you ba
y shares or anything	so you can now help 
ction of the company	oust the ceo
i thought he was ceo	wasn't scully ceo at
t a vote in deciding	ahh that makes more 
rks closely with cic	what
ya	just the classificat
ke regular companies	huh who knew
ew	they had a quote som
ike some hippie shit	right
ing on their website	ikr
a make useful things	disney is going to b
üê±	they seem more of an
they look pretty new	from their youtube c
as of now	i like the concept o
ey're just a startup	yeh true i guess i h
10 thousand srartups	i feel like there's 
ya	and i just wonder ho
their mom's basement	that's kinda dark
ya lol	kinda wish i knew of
e up before they die	i wonder why they fa
bably highly depends	and if what it's doi
ut better and faster	yeh tru i have no ex
l do u mean connectu	yeh they're the same
there by googling it	then how would one g
what's playground	robotics funding pla
 going for pre-prom?	what's pre-prom
before prom	oh is that like
but u should	nvm just found out i
aww that sucks	oh jk amazon sold on
lol rip	yeh i'm making one n
lol r u actuaally	yeh why not, skatebo
's right before prom	you should probably 
p my crystal therapy	lmao
charged up and ready	how would they actua
 suck the energy out	i heard that the ass
t eat into our asses	maybe our asses abso
 time to do this lol	someone who really l
ion is the best part	people will do anyth
saskia has a tesla	yeh duuuudeeee
damn	the fuking door hand
ally a design genius	did he personally de
ike retract and shit	lol
yee	would you ever do so
our robot says hello	yes
orked out in the end	don't be a wuss bruh
st be a terrible ceo	nah i think if it's 
 parts of the system	if one is showcasing
or smthn	oh you mean like a m
s the corsage lookin	doing aight
ut that's probs fine	it's to show that i 
at is it mounted on?	a shit ton of hot go
ure it fits her arm?	it fits mine
lol	so i'm just guessing
nd used to make hers	bruh what lol
t worked pretty well	i thought it was sup
ng as u can't see it	like dicks
üê±	don't forget your pr
 i bring my computer	dude i was just abou
üê±	i needed to get and 
what that	use casanova in a se
ah	wait shit
üê±	i need softer toilet
 still on the toilet	yes
n dressed yet at all	got socks and pants
sed a call from you.	where you at man
rip why?	cuz the snores
bruh	?
üê±	lol what
z it's a requirement	holy shit art histor
 she picked that obe	wow
ya idj	still feel like i'm 
cuz adrenaline	such a bad feeling
i got one	nice
i assume	apparently not
oh wait	shiz that's kinda fa
it right in downtown	what
om the train station	fuck there's too man
also it's at 7	oh so you can walk t
nna be slightly late	yeh sure
wow	btw does this cost m
i don't think so	here now
oomed in on the fist	look around the fist
i'm confused	6.5/10
thanks dude	the fist was actuall
arded with this shit	ok we're done now
guys end up watching	you
lly wanna watch that	sarah fell asleep lo
ya she told me lol	yeh it's my favorite
e rest of weeb night	good night justin!!
 grad parties today?	given that i woke up
probably not	unless i actually kn
reehouse club today?	no idea
rip	probably after sarah
ok	have you been hangin
ya basically	i feel
yup	i better run huh
ya	i slept through midd
*ass	oh no it's bright ou
u know this i told u	i must've forgot lol
ys active but asleep	oops ^^"
ur a fucking bitch	are you guys still t
ended at 5am	so you guys went hom
now it's justin	yeh i could tell lol
woah u could tell?	i'm guessing you guy
no	well justin doesn't 
bitch	lol
in my car	ahhh
talkin	are ya coming for bo
 late i just woke up	the roles have rever
lol	a ups man just deliv
uh	yeh same
how is it going?	im googling so much 
or a conference	seems more like a le
ok i'll check it out	they also use buzz w
machine learning	description from rob
nope	how you gonna get to
*soon	hey
lol	you hate me
u keep saying thattr	üê±
lol	lol sarah worries ab
shit	it's alright man
nope	really??
ting essays and such	what the
 the better programs	wtf lol
ru at botball?	well it's locked rn
asier to do anything	you should learn how
ya..	https://i.redd.it/ye
really hope its real	i doubt it lol
ould flip their shit	fuking lawyers ruini
its a null? or smthn	fuk if i know why js
elp dude i fucked up	what happened?
dvice from sarah now	sounds like she had 
spelled it wrong too	ahhh sarah explained
ya i think so	ahh that's good to h
 gonna get there tho	want me to skate to 
e gym in the morning	wait
rning around 9 or 10	unless you don't wan
hen do u usually go?	when i'm awake
right when i wake up	wow
 the past 3 days lol	well, 3/3 is better 
ve the best vids lol	that was such a crap
st rundown dorms lol	i feel like those ex
e best dorm cultures	i did notice some of
cest dorm is simmons	kevin says if you wa
 a fricking ball pit	you're gonna get pin
not to the pink eye)	i think i'll do body
gym or not at the gy	probs just at horn p
ok	so you're gonna work
but interesting	you should probably 
 he already said yes	this si some weird s
nce which dorm ur in	west hall is only fo
ah	or out on the hills
 ur life quality tho	why do you think i'm
g like college agian	üê±
find weed everywhere	weed wonderland
probaly won't get it	https://www.reddit.c
holy	the simmons videos i
ing different floors	jeezus, i recognize 
 make up the lounges	i'm curious how the 
 about academics tho	what makes you think
 at this very moment	yeh that's true
l try and figure out	i meme soft robotics
bruh	ooohhh
 outside of robotics	that kind of stuff?
for a minute	can't you take that 
or not ur interested	feels like i'm missi
career in the future	things like philosop
in in ur life really	hmmmmm
nowledge or academic	so it would be on th
well	a good way to approa
-changing experience	yeh i see that. on o
through reddit again	yeh
üê±	http://robohub.org/n
lol congrats	basically famous as 
oh woops	lol
e max said he walked	lol
ot back from the gym	bruhhhhhhhh
ed to create some bs	holy shit
 send him some stuff	whew
gone for like 9 days	that's a lot of days
would just be us lol	yeh man lol
 work i can get done	aight
 while i do work lol	chris??
 he just walked over	lol
re the robots going?	going well, not as f
ya i will	how you doing
ill writing my essay	still?? dang
ashley just got home	sounds like confirme
am stuff with her so	tell her i said hi!
gh it and adding ppl	you're doing family 
n't do family stufff	ahh so you guys just
writing my essay :'(	lol bruh
to unscrew some nuts	what
ya...	did something bad ha
i failed tho	what
ya...	what are you doing h
a loitering here idk	lol
 working on my essay	she just wants to ha
jk ily	love you too khloe
ok i'm back	good luck on finishi
e types of questions	that's dumb
tly hard to get into	cuz you could meme t
ehouse in groton, ma	like an honors progr
-orientation program	sounds like a cult
ms that are optional	why is there a speci
 your new classmates	what would one do in
 apparently worth it	number 5 is literall
rently life-changing	what is up with all 
 and its just 5 days	that last part makes
onna be a fun 5 days	the dude said in the
e leaders attend flp	if dat ain't some cu
them are leaders lol	is that part of the 
are u ok today	yeh though someone i
not proving anything	is that why you aske
o may be like-minded	passive aggression w
d get some sleep man	yeh but idk how to e
who's calling u?	lol that would be fu
ah	don't worry dude
üê±	üê±
o do with leadership	perhaps you get to m
use in groton ma lol	and then make out wi
homsky out to groton	it's actually where 
iding in the shadows	lol
lmaoo	i got a boost of ene
 and edit them first	did ya finish? cuz s
ty much done packing	has your mother alwa
ns are more apparent	lmaoo
 after u fell asleep	yeh...
mindblown by ben tho	when ben is in bro m
 extremely different	idk i didn't really 
 into a relationship	lol
ht it boiled down to	yeh that sounds abou
üê±	üê±
ya	it's like if he got 
b except just us lol	yeh sure man lol, we
 be in the dominican	if you're trying to 
üê±	lol what, jenn and v
are pretty close tho	really???
s quite the reaction	i know jenn said tha
again to joanna/vara	what the
ya	wow, this got nerdy 
 or 5th wheeling lol	poor dude getting th
are joanna's friends	awww
which book?	the raibert one
 the divine thrustin	yeh right
ally how i remembere	ahhhhh
?	it was a treehouse m
lol wut	there's apparently a
lol wut	yeh same lol
cally the whole time	isn't shanghai an el
ectronics powerhouse	oohhh thats right
rundown city suburbs	really? what things 
ike buttons and shit	lol
s just my impression	can't tell if you're
 last time i visited	what?? really?? i al
s still pretty dirty	ahh ic ic
like nonexistant	that's how you can r
üê±	üê±
you free those days?	yeh sure what days d
not sure yet	what time do you get
 the 20th and onward	what exactly do you 
e and wanna hang out	ahh yeh so just hang
psychologically fine	well that's a relief
can hang out anytime	i'm also rather behi
tever the number was	oh we could also wat
much do u have left?	~150 pages lmao
that's good	it's kinda crazy to 
but ya i agree	i don't know if it's
 concious feels like	yeh and the fact tha
üê±	üê±
its 3 am isn't it	yeh i should but i'm
printed as templates	oh the dead people p
as such a wide range	yeh right
ardware inside major	the brief explanatio
t memes strike again	righttt
ugh hot and dusty	dusty? really
similar to apple pay	i kinda like cash do
t with their parents	damnn
nctions the same way	i can see potential 
ly censors all media	i'm guessing they ca
 felt more plasticky	ok maybe not all the
 that alexa can't do	ooohhh
re basicaly the same	not sure what mi mea
eans little rice lol	what
ke "love" in chinese	small love?
d u go to six flags?	ahh that makes sense
nice	very quality enginee
heir version of siri	#hardwareisstillafie
how about friday?	yeh sure that sounds
probably yours.	kkkkk
cyaa	shall we stay at bot
ch up on after china	lol wut
like 8	lol
probably	sounds good
leaving my house now	kkkk
rip	welp shit
oh sweet thanks	no problemo
üê±	lol
*clean	yeh that‚Äôs the trick
finitely not my room	what about a drone t
me pretty sweet arcs	what was one those s
oose to work for him	danggg
ng for over a decade	really? that‚Äôs inter
ya i should be	wanna try to watch s
l the parts come in?	yeh, the programmer 
 opened my phone lol	lmaoo
i fucked up	? did you forget to 
john dunleavy	uh oh
d his account hacked	ooohhh
out to be super rude	lol
idk i feel bad now	if it makes you feel
p calling yesterday?	i think it was close
nervous in waht way	she's nervous about 
'm kinda nervous too	oh are you guys not 
i think its a no	you're gay????
tely new environment	hmm interesting
 when u guys talked?	i don't know if she 
 liked anyone before	really??
omach / blushing way	have you ever met so
nah not really tbh	ahh, yeh that does s
to an extreme degree	maybe you'll find th
maybe	just don't get infat
wtf is that	it's a banana with t
ks like that pokemon	yeh no one wants tha
lance is kinda there	isn't that based on 
ya lol	i gotta say though
to be single forever	lmao
lmao	hmm
 bury myself in work	üê±
ya...	i'm sure you'll meet
clubs and activities	or centered around w
ave some friends lol	guessing that's a so
igh school hackathon	oooh huh so they're 
yup	did you see that som
events around campus	oh wait, we're still
keyed	they used a key to s
really	yeh it's on the winc
damn	it's strange to see 
ne in a hammock song	lmao
s the battleship has	and it would the rob
and maga has 2 right	yeh
ddlebot can use more	alright
 at botball tomorrow	i thought you were m
/ tomorrow morning	oh shizzzz
shiiiiit	idk this seems a bit
 nervous in what way	and that it‚Äôll be ha
shit really	she claims it‚Äôs nerv
xpects me to say no?	i got no idea what s
yeh	aight let me spam th
üê±	aight
per emotional person	take it ez though ma
 feel it as strongly	you can feel da angs
üê±	üê±
ll tanishk i said hi	it‚Äôll be alright tho
a sick to my stomach	ah shizzz
?	you‚Äôre nervous too?
well ofc	man i was gonna make
be lynched in oregon	aw man if i was whit
lol	oh tru, and then hav
yup	mannn that‚Äôs some he
till nervous as fucj	yeh
way it ends up going	yeah man
wdym	like how are you goi
uhh	lol what's with the 
idk lol	do ya think a late n
 just wanna distress	but i'm wearing dark
lol	oh wait, i got leds
nna be a lot of cars	i ain't got much to 
joy 3 am walks a lot	hmm tru
4 hrs or 16 hrs lol	4
ion if it goes sourh	lol
lol ya	think i'm gonna take
ya... idk	don't fuck up is als
thanks lol	no problemo
st got back home lol	geezus
houldn't u be asleep	i saw a video about 
well not a bit lol	conflicted how so?
more than i like her	yeh i got that feeli
how to tell her that	that was actually on
ot like all the time	that she likes you m
ya..	that was also probs 
 really a lot or not	you don‚Äôt feel right
kinda	who looks like you
üê±	üê±
listening to am	lol
ya pretty much	 foxy roxy called yo
t it would be a date	use a buck converter
 would be kinda nice	lol damn, what happe
arghh	nice in that you wan
e same as before :'/	yeah she mentioned s
 another person move	lmao
t me looking for jen	nah nah nothing happ
wait this year?	yeh sarah said she w
 don't end up dating	yeh that's very true
be i'll just ask her	oooh, good thinking
but i'm not sure lol	exactly lol, i feel 
ow to deal with this	now with the third o
in boston beforehand	lol
etely ok with it but	lol
to go back to normal	what was normal to y
t ur probably asleep	i was asleep
are u on track	lmao fuk no
rip	 foxy roxy called yo
tuff would iman want	depends on what‚Äôs in
es actual books here	ahhh
lol	uh
get sokmething later	https://www.cnet.com
 dreaded application	feelsbad
ok sounds good	your street is 11 th
yup	that japanese hobbie
ark side treatin ya?	lots of business stu
u do on yr first day	learned air force st
 will kill you" talk	nah that‚Äôs tomorrow
about to board	how long are you the
until the 9th	*whew
damn	you and i never had 
s broken or software	yeh i can‚Äôt say what
oh	using tensor flow
 doing software then	and it‚Äôs hardware th
programming language	i‚Äôm ok with that tho
fuck yea	i can do electronics
lol	‚Äúlook randy, he‚Äôs (g
üê±	jk jk
g field in existence	data science?
od animatronics here	what kind of fancy a
at universal studios	oooohhh
huh that's wierd	have you discovered 
 on the cruise today	wait wuttt
 control than the us	dang now that‚Äôs actu
 go on the interwebs	internet planes that
sed internet so much	welcome back!!!
that was really sad	right dude??
rying in a hospital?	that shit fucked me 
n up on the diahhrea	the comic was why i 
hy in a hospital lol	closing your eyes an
 just visiting again	i was until like an 
aids?	yeh
üê±	heard you drank a be
rnments poisoining u	did you get drunk an
hat's pretty much it	lol
 for alcohol i think	shit i didn‚Äôt realiz
 much black dynamite	maybe
ched another episode	it‚Äôs quite the contr
as also a whorehouse	oh you did??
lmaoo	forgot about that lo
etter than no mamma"	lmao
ya ikrr	some of the lines i 
like honkie lol	lmao nah i knew that
uh	üê±
damn	yeh
 stuff are you doing	something about fore
yo r u home?	yes i am now
oh damn	that‚Äôs why they had 
exercise for interns	yeh the contest is t
r in the later weeks	msp430, that sounds 
h that's pretty cool	‚Äúone week after rele
lmaoo	dudeee
venture i would fund	üê±
ave early from work?	i can technically le
sed a call from you.	i was still ‚Äúworking
lol nah	wait really?? why no
lame with just 2 ppl	working lol
fun	but turned out they 
out doing more stuff	yeh i‚Äôm getting code
 are the differences	the ui is pretty dif
e i'm getting resick	do you need anything
 in helping them too	<3
n our mit group chat	lmao
t i'm a tripllee?!!!	lol
ch out of the triple	ahhh
tually take that pic	not sure
ant to become a weeb	lol
ue to the full manga	niceeee brotherhood 
own a slippery slope	yeh the 2003 one spi
he magic system more	oh no worries dude
okee	sitting next to two 
e this a dress story	lol tru that‚Äôs one s
 bring us some wheed	lmao
ted youtube channels	idk what he‚Äôs like h
k from oregon again?	probs saturday
 next years officers	ahh tru tru, idk jac
es should they arise	oh shit
why?	oh it was just to so
lol	shits hard man
you fox	why does that help e
ooooooh *amazement*"	after saying my og p
s she a normal human	idk
oh shit	and likes doctor who
roy be careful	she seems like one o
branching out	ya know wut i mean
jk i'm tired	like the kind of per
lik edgy linnea?	she just happened to
like it doesn't hurt	fuck honkies amirite
tually get to campus	wait can‚Äôt make that
i mean	lmao
 them your true self	tru
ya np	we happen to live ne
oh lol	aight imma catch som
d don't get too high	thanks dude, have fu
lol	these are the worst 
als look like at osu	nah this set only ex
 your bro needs help	tru bros that are lo
üê±	üê±
allway or in his lav	in the hallway lmao
 did u like stop him	i like turned around
er u from the emails	yeh seemed like it
at the angsty linnea	what kind of a respo
n't k how to respond	yeh tru
ry about it too much	dude your vlog was a
ly and bored at 2 am	 you missed a call f
sed a call from you.	i need to turn this 
 i have is urs right	did you take two? lo
ought it was david's	ah ic ic
ut this in treehouse	lol
is this alex	yeh
but it is a solution	she needs 10k
ng with her finances	apparently she needs
 lust who just died?	yeh roy was a badass
e unaccounted for so	hehehe
 do they need it lol	cuz they wanna have 
found an elo concert	lmao
bly bigger in europe	yeh tru
is british isn't it?	what
runk are super funny	were you like sarah 
ars and marvel a lot	wow
ted a bunch of times	i think i'm feeling 
do u like her?	no
ude way to end convo	but i hypothesize th
üê±	üê±
why?	and fucking emojis s
i'm confused	same
terminal are u using	the standard linux o
 can display emojis?	ubuntu terminal now 
t emojis from a file	in 18.04, which is w
ll part of a package	not sure
oh god	i couldn't find more
üëà(*_*üëà)	lol
lolol	here are some of the
on to do random shit	apparently there was
 enough xkcd to know	here‚Äôs some of black
st one is really sad	yeh...
n that's really cool	also
debate or smthn lmao	no lol, it was just 
 apply to any fetish	yeh, but like
is quite depressing	bruhhhhhhhhhhhhhh, y
lol	i'll be sure to let 
how has work been?	meh, nothing too int
hings that ur doing?	sloc analysis and st
what's sloc	source lines of code
ah	it's used for like e
lol nice which one?	idk what it's called
rrated piece of shit	lmao
i went to the louvre	lol
sick	sick of all the gun 
o that's not as cool	see i‚Äôve been practi
lmaooo	do you have to pack 
l i'll pack tomorriw	lol
ts one day before me	apparently agility w
be a spaceship model	lmao
in europe	you recovered from t
only 20 min away lol	yeh lol, but you‚Äôll 
 schedule in college	no way what are you 
ld be able make time	also this guy alread
hen she goes to work	though it is really 
a while ago	just had to come up 
 across the country?	i don't have any lma
ll read/respond soon	lmao
ring process at work	1986-87
d by a gtech student	apparently it was fu
lol	yuh. dude
e check out my dorm!	üê±
e u guys still here?	eating dinner rn
i can take u guys	we already ordered b
any different events	i just don‚Äôt wanna g
re are u guys eating	area 4 pizza
ke 3 days it's crazy	lol
uite started yet tho	 you missed a call f
ou called foxy roxy.	where you at
i can't hear u	i‚Äôm at the back
are u i'll meet u up	the gyroscopic light
share ur location	how you do that
th ppl at my dorm rn	i‚Äôm at sarah‚Äôs rn
ome over to harvard?	yeh
to u about over call	nah, perhaps some ot
done visiting sarah?	it‚Äôs 11 pm lol
d probably come over	okay
tech had the fastest	66.31 was buzz‚Äôs
rush events schedule	haha yeah sure
ent ur interested in	lol jeezus that's a 
ss than 5% of events	you show up on the s
lmao	nah i think i'm alri
 do with sarah or u?	nah it's nothing lik
üê±	üê±
go to events nonstop	lol
in on the 15th right	yeh
 interesting article	conservatives aren't
asses start tomorrow	lmao, fuk
in my room if u want	idk, probs brushing 
u can sleep there	lol
o hacking if ur down	i'm already sore fro
l the stress that is	you're going to be o
limbing is still fun	how dangerous do you
do it in winchester	what about the bike 
uess that would work	what are you up to r
and doing karaoke	have you joined join
üê±	nah man, i'm genuine
 enter frat bro mode	fuk i woke up kinda 
ging out with sarah?	sarah‚Äôs singing now
ooh nice	u free?
 have more time then	so probs no meet up 
ur time to come over	if i grab onto the b
 the first few weeks	lulu proposed an ide
 u mean tonight lmao	otherwise i‚Äôll probs
f its just one night	lol bruh
rrow when u get home	i‚Äôm gonna be nasty o
me my room's nastier	lulu said her dorm h
nda old and decrepit	it‚Äôs got a fair amou
in there around 8 am	lmaoo
cert or a rehearsal?	idk
 socially exhausting	yeh i'd imagine so l
how does that work	tiny motors
 that's pretty crazy	yeh right lol
on can that provide?	"there are three mus
inner with frats lol	lol
boston beer works rn	wait so is that a no
a frat layer tonight	ahh ic ic
ryone's really chill	how late is later to
m to see the sunrise	lol
od ol' wholesome fun	are you close with t
 just came out today	hmmm
now i have to choose	don‚Äôt choose the wro
he charles basically	btw did you know tha
been a lot of rumors	lol i‚Äôll need an add
oh seriously	i saw him when i vis
oh damn	fairly tall dude, cu
just skating around?	my sister wants to w
parently pretty good	that sounds like a g
contact in that frat	gotta say though my 
f potential recruits	but my hips creak no
nice nice	ohh ic ic
h is ending soon tho	lol it‚Äôs no prob man
at life is dangerous	aw shit dude
 big toenail anymore	holy shit what
ya	what the hell were y
ts just dangling off	please tell me that 
 out and bandaged it	so you‚Äôve just don‚Äôt
ol no they grow back	well maybe you can m
aying sand wrestling	you could‚Äôve been bi
with a frat	you guys said no hom
as lifted 90 degrees	geezus christ
lol	guessing this was du
ome to wet wednesday	that‚Äôs a terrible na
arties going on then	ohh i remember lulu 
whos kiera	hmmm i‚Äôll probably b
dafuq	she‚Äôs pretty chill
ealing mit girls now	lol
jk	üê±
nd one day with lulu	well neu, bu both ar
erally just skating?	just yesterday when 
ot on campus rn r u?	i‚Äôm on next houses r
ice parking lot view	nah i‚Äôm just fuking 
üê±	kiera and lulu say t
 consensus ive heard	so don‚Äôt visit mccor
 crazy cool building	rip kiera
yup	my goal is try to ma
w thats so wholesome	it‚Äôs a lot easier wh
 up any parties yet?	nope lol
the frat i'm rushing	isn‚Äôt that like ever
more chill kickbacks	oh that‚Äôs a lot nice
lmao who's some ppl	kiera mentioned some
ya dude its so good	reds literature ones
g everything in june	whoa this is getting
alright copier	oh yeh btw
 when ur in the city	at least that‚Äôs what
or pm	yeh i catch a ride w
 or only on weekdays	i was thinking of ma
 are u in cambrodge?	nah unfortunately it
okee	feel like it might b
ht's i'm pretty free	my biggest concern r
i mean i can ship it	but that'll take a l
üê±	wait a sec
yupyup	fuk lol
wtf	it‚Äôs good shit dude
me to wet wednesday?	yeh sure lol
 address of the frat	oh btw i'll be in th
oh awesome	not sure exactly i'l
ub meetings at night	oh you've already jo
hat tho we can chill	lol bruh wut i thoug
u could chill there	chris yang is here??
 the library with me	i‚Äôll need an address
s to library or next	lib lol
 come down to meet u	kkkkk
6179570655	i just realized i do
lmao	i‚Äôll text and or cal
t u got a new phone?	nah it‚Äôs the same on
ok one sec	it‚Äôs so stuffy outsi
where u guys now?	we‚Äôre bumming outsid
 able to go until 11	lol
lol	holy what
oining to try it out	why is everyone beco
üê±	üê±
s the first meeting.	yo i just realized s
yet	lol
how is it	pretty good
dive into the lyrics	kinda wished burr ha
oh	üê±
orld was wide enough	oh damn you got it a
his video is so good	lol i‚Äôll take a look
barker library	bruh
to the parties? lmao	idk now lol
eta xi at like 11:15	wait wut lol
u have adt until 11	üê±
 memory doesn't suck	where you at
oh r u at a party?	i just left
left mit?	nah i left theta xi
how was it	yee
be careful lol	i accidentally hit t
hots taste like shit	turned out it was tw
 u have asian flush?	nah doesn‚Äôt look lik
't get too drunk man	lol nah i have no pl
finishing some psets	üê±
was actually a rager	pbe was so crowded l
that's good i guess	honestly thought i w
art feeling nauseous	kinda wish i had my 
kate drunk at oregon	hey i‚Äôm trying to br
d bleeding during it	esp with ur toe?
apped up so all good	bruh
 memes this time lol	nah it‚Äôs aight lol, 
oh lol	kinda wished i was m
eres no reason to be	but i wanna be a koo
like legged robotics	i bet dr kim used to
üê±	üê±
ver practical skills	techx application is
any self-deprication	you probably worked 
ach their life goals	aight i need to list
o read up on his bio	damn alright
just wiki lol	the ultimate bios fo
curate i don't think	aw man
 shitty startup idea	ofc
a pitch contest lmao	lmaooo
rov pitch skills lol	yuhhhh
at pe class lmao	should i head to the
üê±	lol bruh
i can meet u there	i just saw damian lo
 pe class ended at 6	you in the infinite 
yup	bruh lol
u guys end up going?	ahh sorry sorry
what'd u guys do?	i got some pants
lol oh right	yeh i was at bu
be careful	dude im finally able
congrats lol	where u at rn?
r u still at mit?!	i was at mccormick
oh	the view is freaking
on campus hands down	yeh i was hanging wi
u still on campus or	nah i‚Äôm back home no
whether or not to go	rn??
#fuckbus	fuckbus?
ya	uh...
üê±	jeeezus
ay thats a lot a lot	yeh cuz it's a lot
üê±	yeh tru
üê±	üê±
g haha more actually	this might sound fuc
roup uses haha a lot	exactly dude
s u don't k use haha	wait a sec that does
bulding ur harem	fuk i'm turning into
 didn't k u were gay	üê±
i support u	wait no
i don't think so	lol
iggered for a moment	lol that's quite the
are you outside?	almost
omw	how was the hack?
it's not over yet	lol
pportunity like that	i am not already in 
't emailed him back?	yeh bruh
he have a secretary?	lol wut
udents === secretary	yeh tru
what did he say?	if i piss on the equ
lmao	no classes were open
has a sense of humor	it‚Äôs called art 204 
most useless subject	üê±
üê±	i‚Äôm afraid that i mi
be spewing buzzwords	a couple reminded me
sting thought spiral	ahh sorry i was out 
ie are hittin it off	interesting music, i
she talks to animals	idk about that lol, 
oh ic	in my defense i have
lol wut	yeh idk why either
is that agility?	nah
wait so ur in?	i guess so?
whelmed in what way?	i‚Äôll explain in deta
ee it all worked out	nah
to a lot of things	this sounds familiar
 ducj fuck fcuj fuck	lol first step is to
i me to make friends	i should disagree wi
every other thursday	every other thursday
true	you and sarah both s
ew why matlab	cuz it‚Äôs built in di
rk on these projects	yeh that‚Äôs why i nee
ath do u need to do?	but i don‚Äôt have muc
t sounds complex lol	same
üê±	what companies thoug
-- grad level talent	yoooo skydio????
ut of nick roy's lab	i see you‚Äôre into wr
ogy seems super cool	ooohhh that‚Äôs more i
ent machine learning	that tech is dangero
r unethical purposes	they can use that to
not used unethically	ahhh ic ic
l of the blockchain"	one senior i know li
demo, it was so cool	i can‚Äôt even fathom 
w much i can finesse	what kind of compani
for internal tests g	sounds about right
ade a music video :o	holy shut
y working on cassie?	lmao
üê±	have you organized y
 career fair is over	that‚Äôs good to hear
social stuff i guess	feeling more confide
going to parties now	do you actually like
up and bad decisions	but now you want to 
üê±	ahhh
ng me until idk when	hooking up with some
ctually gonna hookup	yeah, she was distra
matter to begin with	hmmm
t acapella and stuff	yeh?
 the hunt" for girls	yeh it is rather iro
 i'm not over it....	hmm yeah it would ap
sorry for the rant	boiling for almost a
riend on the outside	yeh she mentioned yo
ked home in the rain	holy shit did you re
was only like 30 min	hey on the bright si
üê±	üê±
ook 4 days to decide	hot damn
wdym	do you want to still
ny negative feelings	are you sure about t
w haning out with me	it‚Äôs not your friend
ow that she has a bf	yeah that's true
xed feeling of irony	sounds like heartbre
y for no good reason	it seemed both of yo
fraid of this result	you also seemed pret
üê±	i would commit suici
üê±	hmmm you wanna call 
uriously typing lmao	lol bruh
nk things will be ok	alright that's good 
lol	holy shit dude
o what work ur doing	i‚Äôve never been so h
del are u working on	i‚Äôm creating it
ing for midterms lol	shit wut lol
idterms per semester	lol wut
is week or next week	that‚Äôs kinda gross
ests do u guys have?	fuk
rip	just a regular old m
yup	you‚Äôve been feeling 
ning about wellness?	it‚Äôs part of my requ
ating pretty healthy	really???
which feels wierd	that‚Äôs one step clos
f veggies for dinner	the poor lonely star
gym class is working	why you hitting two 
lmao wut	fruits and veggies
r gay ppl fruits	lmao i wish high sch
ssion in art history	hey don‚Äôt joke about
w will become shitty	lol nah that thinkin
ace of the girl kira	i'll be honest i hav
r is knda irritating	wait a sec
 hate this character	üê±
üê±	lol
falling behind?	dude my ece class is
tunity anywhere else	i had to explain to 
wamped and hate life	yeah, maybe i'm frea
mostly upperclassmen	yeah i've been aroun
on coming up i think	but i only see them 
ust to scout out ppl	you know how i feel 
on tech shit for fun	isn't that just the 
der as much pressure	my moment of worry w
lways create filters	yeah i suppose so
 might dampen things	yeah that's true
xcited about my urop	is that like a sex t
yes	nice dude
üê±	oh yeah, your urop w
by mit	if i haven't said it
ade the right choice	yuhhh
z my hands are taped	lol wut
ns game with my frat	that's uh, huh
t hand to stay alive	ohhh
yee	do you slap people s
having it in my hand	huh lol
ol like $25 or smthn	that's not bad tbh
ree food game at mit	i thought you were e
oods and gluten free	don't forget about y
ey took that with er	oh shi, don't worry 
link that xkcd comic	lol
r computers not mine	oh shi, 14.04??
heir older computers	lol bruh
 should probably gtg	lol yeah, sounds guc
lol thanks	shit dude
shoot	lol wait shit i‚Äôm sk
lmk	back
st study math today?	yeh, apparently a fo
üê±	i just don't know if
why not?	hw
d is the math class?	idk, not that hard r
rip	yeh right
t ya it feels longer	dude you didn‚Äôt say 
üê±	dude the guy who was
if he wanted to play	idk, the show has ro
ant to play with me"	tbh nothing smells y
itors/cleaning crew?	we have one for the 
oh ic	oly fuck dude
e u heard this song?	no, i‚Äôll give it a l
m not in the bu area	*whew
yup	what did ya guys do?
thats pretty much it	awwww
 back on her own lol	oh did she drink?
but not a lot	dude do you know wha
wfym	yeh idk either
losing grip strength	idk when i woke up t
get that checked out	nah it‚Äôs ok
is ur hand ok now?	eh kinda
ya go ahrad	i just went to the r
 enjoy what they do?	i've never done full
 up responsibilities	and i also see what 
? wdym	as i was talking to 
üê±	ok, got sarcastic th
 would enjoy ur time	fuk dude, i even tol
why would it be rude	lmao
spending on robotics	i spend at least 2 h
lol	so if i just walk in
u have an obligation	they told me don't f
ntion the money part	but i do
s it worth the money	that's the problem i
or personal projects	i guess it would be 
ough just don't join	the way it works is 
ent responsibilities	danger's my grandmot
 fucking old man wut	sorry, shitty, not w
le to quit in a week	personally, i though
e if i blahblahblah"	all i asked was if t
ies u should be fine	what do you mean esp
üê±	that was pretty good
h giving out ur time	now that i think abo
e and precious tkme5	i got into auxivisio
üê±	üê±
g those expectations	yeah that's true,
hat's the other lab?	human robot interact
the wut	the charisma lab
an robot interaction	various
üê±	i appreciate you inv
ade the finger thing	ikr
amirite	i don‚Äôt get it
üê±	my biggest news of t
that was really cool	oohh ic ic
i've seen that	it's quite the compe
yo	ye?
i was just bored lol	nioce bruh
artition for ubuntu?	out of my 1tb harddr
ll gonna be using it	only 85 gb???
ye	what the heck is eat
indows is just a hoe	on ssd (124 gb total
out as much as i can	feelsbad
 at this fucking hoe	yeah that's ridiculo
and not do home	oh btw you don't nee
wanna update distros	are you not going to
x on ur old computer	i know a guy here wh
for ubuntu	oh that was the thin
cess really annoying	eh it was aight, jus
id you use it all up	yeah pretty much
 for future projects	robot simulations th
oh ic	those datasets you c
ya	back at booz allen t
 shit ton of package	well fuk them then, 
 fine with maybe 60?	and use the other ~2
leave 25 for windows	yeah i suppose that 
ust a root partition	60 gb would probs be
well	the only problem i s
opencv huge packages	maybe like half a gb
c libraries included	holy shit
of simulation models	oh in that case i be
like videos or smthn	maybe
üê±	i don't think republ
 be an art historian	like i always knew t
erally every day lol	lol it‚Äôs aight i was
 i'm down for a call	i‚Äôm sitting here doi
ok	wow dry is so much w
lize it was that low	lol
ye	you still wanna chat
be/3sau5racsge?t=263	 foxy roxy called yo
: )))))))))))))))	üê±
üê±	üê±
bably the right move	i agree to that, esp
arah was calling sam	lol
rip	yeah, you two just n
*bonding	was that a freudian 
üê±	wait, hadrian was ga
or rather bisexual	it's probably the wa
üê±	üê±
 from 4 yrs of latin	oh my god what
üê±	how's your intro to 
how was ur midterm?	midterm was easier t
r marketing strategy	ooh around the level
y its actually crazy	lol
just like cmu	yeah that seems to b
to other schools etc	but if you do your m
üê±	did you know industr
dn't be standardized	i‚Äôm surprised they d
ers attractive thing	like i thought most 
ship with anyone yet	lol
üê±	oh shit man
 moment in the story	there‚Äôs something ma
k i screenshotted it	yeah i couldn‚Äôt find
s tammy i think lmao	priorities lol
yup	where did they go fo
re i end up homeless	lol nah dude you‚Äôll 
g deja vu in a dream	turned out there‚Äôs a
lol w\ut	yeah same
hanign out with josh	fuk dude
right arm is missing	dude when i saw the 
oooh thanks	i notice every assoc
?	i'm going to just go
laborate on da feelz	i just get all tired
üê±	that is not what i m
hmmmm	idk, talking/thinkin
i'm justin yu" memes	lol
 wus and just say no	every time we intera
ude these signalzzzz	she has a boyfriend
and fix my hardware"	holy fuk
u have like a squad?	i feel like i don't 
a activities do u do	hang out in the lab
ngs with ur lab? lol	holy shit
rrent neural network	are you going to blo
fuck bad timing	lmao
sorry go on lol	nah that's about it 
terested in them lol	like look at this du
oh so corporate life	yeah fuck man
hmm	i think it may be th
wait elaborate	i came here for the 
outside of ur lab	yeah
y itself has meetups	bruh, i live in the 
branch out of ur lab	why do i need to be 
s like mental health	lmao
portunities and such	for the first one, i
lmao	maybe i should check
ya do it	or i could become a 
at least for me	lmao fuk, time to bo
 looking at startups	you going try skydio
ng enough regardless	show them up, show t
so we'll see	oh damn that‚Äôs inten
 a good way to learn	and also emailing ma
enring for agilitiy?	lol i have no idea i
r u for an interview	i only just got a co
wages but onboarding	i guess i could stil
ave a good advantage	worst case scenario 
r housing on campus?	agility is a 20 minu
bike	it‚Äôs rural af outsid
lol	first i suppose i‚Äôll
üê±	well shit you‚Äôre not
ut of bill gates ass	i know, but i need t
sorry i'm tired	holy shit
 his midsection then	that‚Äôs supposed to b
 to be the dick lmao	this whole paper is 
n the head of a dick	lol
have full body dicks	there‚Äôs a whole para
smh	that‚Äôs why their emp
eally have an empire	virgin athenians vs 
in the delian league	well i‚Äôm sorry if an
tention in 6th grade	lol
in elementary school	oh yeah i recall you
holy shit	here‚Äôs a question
e an answer in a bit	lol the question onl
d b completely wrong	baidu demos stacl (s
like ubi and shit	dude
me wish i were smart	it's a bit of a long
rip	oh shi, then i shoul
blame sarah	i'll lol
üê±	no
 around chadding ppl	otherwise i was movi
 and rip his diploma	lol
to be more assertive	i'll tell ya another
damn lol	good luck man!!
thxx	üê±
hbu	insecure?
en im tired and sick	it‚Äôs not about sarah
nah nah	oohhh
d on a lot of things	behind?
losing out both ways	lol
or at least with me	there's an easy fix 
thanks man lol	lol no problemo, i'm
c ppl are all asleep	do you feel more con
part i'm not good at	so you feel as if yo
ye i guess	what do you want to 
t feels kinda shitty	yeah i suppose so
-4 hrs the past week	yeah you best take t
as do i but still	i don‚Äôt care that vi
üê±	i‚Äôve been pondering 
productivity is less	how can one be unpro
 class is teaching u	yeah teaching me pro
ed early tonight too	oh damn
no homo	<3
ate on saturday lmao	holy shit what
en throw a rager lol	what the
 floor tradition lol	ohhh
lol why	cuz these computers 
th yr senior do to u	i technically sit at
üê±	he‚Äôs also got a high
ut anyone in a while	he‚Äôs obstructing wor
e spaces for laptops	i did when i first a
tta be less nice roy	yeah
 go out and chad ppl	what i just don‚Äôt ge
ve is rightfully urs	next time i'll grab 
üê±	üê±
expectations are low	why so?
iend out of this tho	ayyy, that's a good 
thanks man lol	of course of course
t the 3d printed one	yeah it was a calmin
ted by 3 teddy bears	üê±
/watch?v=n3c5gn15kas	lol wtf
no its a big meme	like the last jedi?
eeeeeeeeeeeeeeeeeeee	lol
chievements obselete	oh my god i can't be
breastfeed in public	how do we know those
 thats due in 10 hrs	past 3 am it‚Äôs morni
d also be asleep man	holy fuck i just puk
are you ok	yeh idk what happene
ually work like that	what do you mean by 
lol	the old one just cou
actually pretty cool	ikr
bitch lmao. love you	did sarah send that 
ya lol	you ever have moment
y when i take a piss	huh
n grinding are psets	fuk, my times are of
üò´	wow when you put it 
? no	the virgin group
wut	
what the	"richard branson fou
ll on the same group	yeah dude it's insan
lmaooo	dude i finally did i
?	i finally asked a gi
hold on	nah i‚Äôm just fucking
üê±	know me so well :‚Äô)
üê±	üê±
st have talked to me	or they know someone
true tbh most likely	hey at least they di
 is that a reference	lol yeh man
ya.....	i‚Äôve basically ascen
lol thamks	how was the date
ates happening at 10	apparently they theo
y started 30 min ago	wait
from cow and befire	"i was already know 
o lo  k3km	wanna vid call?
 i can call in a bit	damn feelsbad
charge	be careful then, don
e you stop watching?	lol
was it when l died	i just found mello a
 rate spiked so hard	well shit man i didn
hed the ending then?	yeah, i eventually s
eath note is so cool	hm something about t
lmao	but then again last 
me by 70% in 5 years	i mean hilter also p
do justify the means	but the world doesn‚Äô
y as many guilty ppl	it‚Äôs best not to tra
d try to save vision	well the clear reaso
 of stone cold logic	oh like how in the b
good	lol so many themes a
fpqowierjoifjoqijwef	lmao
as so good holy fuck	so uh, weeb huh?
lmao	is there anything ne
 i watch a weeb show	code geass season 2 
akes up so much time	lol
is so time expensive	wait, don't tell me 
ly right up my alley	lmao
yes basically	you need to watch co
cuz im not a weeb	cowboy bebop is _the
nder is not an anime	the creators clearly
üê±	jesus-loving lmao
üê±	yeh cuz i'd rather f
ucking bitch ya know	there's also the mom
or something	and also when you tr
max send u the video	"i'm the sun bitch! 
oh ya lol	nah i saw everything
 where are my pants?	i also like how you'
just gonna die alone	don't be a little bi
do it ya little shit	nah man, max and i j
uotes from the movie	holy shit
so the force is dope	blocking gunshots wi
utally midicholrians	how the fuk do bugs 
shhhhhhhhhhhhhhh	yeh ok man
ly over winter break	oh shi
u with specific ppl?	no lol
his for next summer?	where he spent a sum
 in person interview	dayumnnn
üá∫üá∏dayüá∫üá∏dick ‚öñÔ∏èüíØüçÜüî•üí¶üëÖüò©	voting?
lol	what do you think th
uh	and i have no idea h
 like a week ago lol	lmao
 ur birthday is safe	yeah i suppose lol
esume that i'm using	holy, your resume an
such thing as better	idk man, you have wa
interview ur all set	i can‚Äôt talk about w
*still talk about	i suppose so, we‚Äôll 
 already really good	there are people who
lking about a resume	oh yeh
 it in the right way	i‚Äôm pretty sure i‚Äôm 
re official title is	since i came in rand
ould put yourself as	‚Äúvolunteer researche
ya that works too	yeh true
on't put "volunteer"	idk why i suddenly h
ack loop of bitching	lol what the
üê±	üê±
eral i'm pretty shit	yeah i suppose that 
ye there we go	also i think matlab 
 loops are so useful	i think python just 
ts probably not shit	the skeleton in term
it doens't open	yeah, cuz windows re
lmao	short resume.pdf
s don't all match up	lmao fuk
f it being sentences	da fuk is this conve
 something like that	aw shit, but doesn‚Äôt
ible for each bullet	is this what graphic
lol	don‚Äôt like how godda
bly wouldn't do that	aw man
n your interview tho	what if the resume p
then its up to you	hebi robotics is sti
ckground looks wierd	whattt
is fucking hilarious	lol
 first gun today lol	wait wut
day was shooting day	wait wut i thought y
hat's for half a sem	üê±
s ancient jewish art	greek with red-figur
 by arctic monkeys üòç	"i got my hopes up a
/watch?v=wycjnccgues	wut, you're into psy
 a few i really like	oh yup, that's defin
 of not psetting lol	ahhh
to the strokes a lot	bruh, why you on my 
got inspiration from	get off mah lambda
yoooo	i had no idea that t
 strokes to start am	ah yeh i can see whe
lol	lmao
bruh bruh bruh bruh	whoa
is is one fat lambda	i'm also on windows 
rip lol	yeh, either the velo
 is such a good song	apparently the physi
didn't like reptilia	ye, my prof literall
 that's like carlson	only problem is sinc
 forced to be social	i haven't seen direc
 actually concerning	didn't stan lee pass
cial commitments man	i mean, i can still 
sleep is a good idea	da fuk you sorry for
sition college thing	oh i did want your o
ya..	idk, that just left 
 labor, namely wages	yeah, but that‚Äôs wha
s ways to make money	yeah, that‚Äôs very tr
ye...	time to learn footba
step outside ur room	or i can keep on ban
lol no roy	i notice i rant main
 sleep cuz it's 4:40	fuk damn sorry sorry
ur existential dread	lol
wdym	for a small startup 
uld u add by waiting	fuk time to submit
read it rn if u want	nah it‚Äôs alright, yo
 anything u can add?	you must have more u
rom studying anyways	idk, they‚Äôre an actu
üê±	no homo
done	oh damn you fast
its all good lol	damn, i think rethin
üê±	üê±
good luck!	thanks man
lol	oh shit
ed the past few days	you stressin'?
y're both fiberglass	yeah that‚Äôs very tru
lmaoo	you ever have those 
 been helpful for me	damn that‚Äôs really o
 spend on each thing	lol i used to use th
lmao nice	yeh idk, sometimes i
yet? or just chillin	continuing the resea
meh	really??
ed to finish tonight	üê±
hanks for asking tho	https://youtu.be/4fe
lmao wtf	hey man, what can i 
youtu.be/q3uy2kwod4q	idk if i wanna watch
üê±	was that a jab at my
n ruin yo brain *eh*	lmao
yup	fukkk now i really w
its not too late	lo siento
damn	hey hey
 tomorrow i'm freeee	yeee, get that good 
 shit happy birthday	lol
hen is ur bday again	lol
oh ripp sorry man	lol no need to be so
how s thanksgiving?	lots of chinese rest
ets from alex turner	yeh, i had to go out
that's right bitch	üê±
what were u doing	i found some strange
 my windows side lol	i planned out each h
damn	üê±
te eachother on life	holy crap i need to 
n do your finals end	wednesday
lol its all good	i need to read that 
some black eyeshadow	and then listen to m
see them or anything	lol
ill be but we'll see	i swear if it turns 
lmao	how is it gonna work
ters that come after	wait so it doesn't e
im still tryna grasp	it might follow up w
ya	i wanted to say some
ng as fuck sometimes	btw do you know what
lol	oh
anting to leave osu?	nah the lab
 and ur family right	but then the researc
so go back for break	some of them are sta
sp over winter break	i hope they get more
is probably gone too	that's true ppl stil
es u gotta step back	welp shit that might
he download file :'(	lol yeh, this chat m
damn nice selfir	yeh
ait gimme like 5 min	aight
he video chat ended.	aha! i think i‚Äôve fo
vent.aspx?id=939&p=1	yeah i think i put t
 is going on thurday	oh shit
enly gets realy good	like alcohol?
üê±	üê±
arctic monkeys album	is it just me or has
ot to arctic monkeys	you‚Äôre the most reas
context?	lorenzo, masters stu
 on over not knowing	yeh that‚Äôs true
cial interaction lol	comparatively to the
can't go wrng lol	like your social int
üê±	üê±
fucking weebs	coming from the dude
 multicultural quips	that‚Äôs what a weeb w
t a weeb your a weeb	your idea of a perfe
at so warm and fuzzy	all the anime movies
ol fuckinf catholics	fuck yeah it‚Äôs good
in you all along :')	yeh fuk dat noise
lol wtf	right?? they‚Äôre so b
welcome back!	thanks my man
at 6 is not sold out	lmaoo
 sell them on campus	aight
f u just pay me back	aw shit wait do you 
 i don't talk to her	shizzz
oh	it‚Äôs aight though i 
y keeping an eye out	i‚Äôm here tonight for
who's kathryn	lulus friend
who's kiera	short, asian, from n
ok i mixed them up	but she‚Äôs also the g
ye	fuk that also came o
ut she was the snacc	i should just stop t
what recital	music chamber thingy
nope	fuk dude i woke up t
damn	it felt
sh on the west coast	at least not the pac
damn	aight time to start 
t the student center	do you think they ha
ey mainly take venmo	bruh fuk
lol i dont	jk jk i can ask arou
ye	gonna be balling
 u miss the red line	nah it ain‚Äôt
t coast is def worse	man outside looks gr
yeee	yeh my goddamn it‚Äôs 
s so nice and serene	you should watch it 
fucked up at my frat	lmao
üê±	‚Äúwhat a beautiful ev
 time to get wasted"	‚Äúwith my frat of all
:')	fuk i‚Äôm lost already
u arrive in kendall?	yeh
n from north station	yeh
you have to walk	fuk i should‚Äôve brou
lol	lmao
u're fucking welcome	hardcore meme right 
üê±	if i see sang bae ki
st flash your cassie	stick up my middle f
lol	a lot less abgs here
ng boba in campus rn	lmao
are u here?	yeh
 on the second floor	there‚Äôs an art galle
st straight up black	how are you still al
i might keep it	you‚Äôre gonna die fro
yee	lulu just left with 
oh nice	goddamn it‚Äôs so nice
at next?	nah
 it on the 5th floor	nah we went down som
 dome or little dome	there‚Äôs a little dom
lol	damn
at bc	ahhh
t rehearsals tonight	ahhh
back to back lol	i see where your gai
